Player,Pos,Age,Tm,G,GS,MP,FG,FGA,FG%,3P,3PA,3P%,2P,2PA,2P%,eFG%,FT,FTA,FT%,ORB,DRB,TRB,AST,STL,BLK,TOV,PF,PTS
Precious Achiuwa,C,22,TOR,44,22,1047,140,332,0.422,16,54,0.296,124,278,0.446,0.446,39,70,0.557,101,214,315,51,24,27,44,88,335
Steven Adams,C,28,MEM,52,51,1354,134,253,0.53,0,0,,134,253,0.53,0.53,78,134,0.582,227,266,493,162,48,33,84,91,346
Bam Adebayo,C,24,MIA,30,30,985,205,396,0.518,0,3,0.0,205,393,0.522,0.518,139,180,0.772,80,219,299,106,47,19,89,96,549
Santi Aldama,PF,21,MEM,27,0,277,37,97,0.381,4,39,0.103,33,58,0.569,0.402,12,20,0.6,23,41,64,14,2,7,9,27,90
LaMarcus Aldridge,C,36,BRK,36,11,825,207,373,0.555,12,38,0.316,195,335,0.582,0.571,58,68,0.853,54,148,202,31,13,39,32,63,484
Nickeil Alexander-Walker,SG,23,NOP,50,19,1317,237,632,0.375,95,305,0.311,142,327,0.434,0.45,70,97,0.722,36,128,164,139,41,19,85,88,639
Grayson Allen,SG,26,MIL,46,45,1298,187,437,0.428,117,297,0.394,70,140,0.5,0.562,48,56,0.857,25,135,160,70,38,15,28,64,539
Jarrett Allen,C,23,CLE,47,47,1531,310,465,0.667,1,10,0.1,309,455,0.679,0.668,140,204,0.686,170,355,525,85,36,64,83,85,761
Jose Alvarado,PG,23,NOP,27,1,335,50,119,0.42,15,49,0.306,35,70,0.5,0.483,14,21,0.667,9,27,36,54,30,3,10,37,129
Justin Anderson,SF,28,TOT,6,0,77,6,19,0.316,3,15,0.2,3,4,0.75,0.395,6,7,0.857,2,8,10,9,2,1,3,9,21
Kyle Anderson,PF,28,MEM,43,8,955,134,311,0.431,26,76,0.342,108,235,0.46,0.473,46,70,0.657,41,185,226,112,49,26,43,64,340
Giannis Antetokounmpo,PF,27,MIL,46,46,1499,461,848,0.544,54,178,0.303,407,670,0.607,0.575,367,508,0.722,86,433,519,275,45,66,153,148,1343
Thanasis Antetokounmpo,SF,29,MIL,33,5,347,38,83,0.458,1,11,0.091,37,72,0.514,0.464,15,24,0.625,30,47,77,19,13,8,19,56,92
Carmelo Anthony,PF,37,LAL,50,3,1327,229,524,0.437,116,296,0.392,113,228,0.496,0.548,98,119,0.824,41,167,208,52,36,41,44,112,672
Cole Anthony,PG,21,ORL,42,42,1396,254,648,0.392,91,278,0.327,163,370,0.441,0.462,149,175,0.851,27,220,247,257,37,12,117,113,748
OG Anunoby,SF,24,TOR,38,38,1413,263,590,0.446,95,265,0.358,168,325,0.517,0.526,78,105,0.743,61,158,219,101,62,23,69,113,699
Trevor Ariza,SF,36,LAL,18,8,350,25,69,0.362,19,57,0.333,6,12,0.5,0.5,7,10,0.7,5,55,60,23,10,4,8,18,76
D.J. Augustin,PG,34,HOU,34,2,510,55,136,0.404,39,96,0.406,16,40,0.4,0.548,33,38,0.868,7,34,41,74,10,0,45,17,182
Deni Avdija,SF,21,WAS,53,6,1206,143,322,0.444,44,144,0.306,99,178,0.556,0.512,56,75,0.747,34,224,258,86,40,30,46,120,386
Joel Ayayi,SG,21,WAS,7,0,20,1,6,0.167,0,1,0.0,1,5,0.2,0.167,0,0,,1,2,3,4,0,0,0,0,2
Deandre Ayton,C,23,PHO,33,33,967,231,364,0.635,2,8,0.25,229,356,0.643,0.637,66,91,0.725,91,251,342,50,27,25,56,76,530
Udoka Azubuike,C,22,UTA,13,5,149,23,34,0.676,0,0,,23,34,0.676,0.676,4,9,0.444,13,39,52,0,1,10,10,17,50
Marvin Bagley III,PF,22,SAC,30,17,656,114,246,0.463,15,62,0.242,99,184,0.538,0.494,35,47,0.745,67,148,215,17,9,11,21,50,278
LaMelo Ball,PG,20,CHO,49,49,1589,348,823,0.423,126,349,0.361,222,474,0.468,0.499,148,171,0.865,80,268,348,366,77,20,154,153,970
Lonzo Ball,PG,24,CHI,35,35,1212,162,383,0.423,110,260,0.423,52,123,0.423,0.567,21,28,0.75,35,155,190,178,64,31,82,85,455
Mo Bamba,C,23,ORL,45,43,1180,179,381,0.47,57,166,0.343,122,215,0.567,0.545,38,48,0.792,95,265,360,60,29,87,57,115,453
Desmond Bane,SF,23,MEM,52,52,1564,344,750,0.459,146,358,0.408,198,392,0.505,0.556,78,87,0.897,30,201,231,128,59,24,77,127,912
Dalano Banton,SF,22,TOR,43,1,505,60,149,0.403,11,38,0.289,49,111,0.441,0.44,18,28,0.643,27,67,94,70,21,8,45,52,149
Cat Barber,PG,27,ATL,3,0,13,0,4,0.0,0,0,,0,4,0.0,0.0,0,4,0.0,1,2,3,3,0,0,1,1,0
Harrison Barnes,PF,29,SAC,52,52,1755,271,586,0.462,106,257,0.412,165,329,0.502,0.553,242,292,0.829,57,262,319,131,37,9,82,65,890
Scottie Barnes,PF,20,TOR,45,45,1620,262,552,0.475,39,120,0.325,223,432,0.516,0.51,103,139,0.741,114,231,345,153,43,37,87,128,666
RJ Barrett,SF,21,NYK,48,48,1587,306,743,0.412,96,271,0.354,210,472,0.445,0.476,155,223,0.695,41,231,272,125,26,14,94,98,863
Will Barton,SG,31,DEN,47,47,1533,279,628,0.444,110,293,0.375,169,335,0.504,0.532,63,81,0.778,32,202,234,195,41,25,88,74,731
Paris Bass,SF,26,PHO,2,0,7,2,6,0.333,0,2,0.0,2,4,0.5,0.333,2,2,1.0,2,2,4,0,1,0,2,2,6
Charles Bassey,PF,21,PHI,22,0,161,28,43,0.651,0,4,0.0,28,39,0.718,0.651,8,11,0.727,20,40,60,7,4,17,8,31,64
Keita Bates-Diop,SF,26,SAS,42,12,701,92,184,0.5,14,42,0.333,78,142,0.549,0.538,29,42,0.69,46,124,170,25,19,13,29,43,227
Nicolas Batum,PF,33,LAC,35,30,871,112,232,0.483,68,168,0.405,44,64,0.688,0.629,16,24,0.667,16,139,155,55,35,26,27,51,308
Kent Bazemore,SF,32,LAL,31,14,455,39,119,0.328,23,65,0.354,16,54,0.296,0.424,13,17,0.765,9,45,54,29,20,6,10,56,114
Darius Bazley,PF,21,OKC,49,33,1309,170,424,0.401,50,171,0.292,120,253,0.474,0.46,76,111,0.685,56,258,314,58,39,55,67,47,466
Bradley Beal,SG,28,WAS,40,40,1439,348,771,0.451,63,210,0.3,285,561,0.508,0.492,169,203,0.833,38,151,189,265,36,15,135,95,928
Malik Beasley,SG,25,MIN,55,10,1421,242,637,0.38,163,455,0.358,79,182,0.434,0.508,30,40,0.75,21,146,167,82,29,8,37,66,677
Jordan Bell,C,27,CHI,1,0,2,0,0,,0,0,,0,0,,,0,0,,1,0,1,0,1,0,0,2,0
DeAndre' Bembry,SF,27,BRK,48,20,949,121,213,0.568,15,36,0.417,106,177,0.599,0.603,21,35,0.6,38,114,152,60,47,25,30,104,278
Dāvis Bertāns,PF,29,WAS,34,0,501,60,171,0.351,46,144,0.319,14,27,0.519,0.485,28,30,0.933,6,55,61,16,11,6,14,55,194
Patrick Beverley,PG,33,MIN,36,32,931,112,276,0.406,48,144,0.333,64,132,0.485,0.493,48,68,0.706,40,121,161,180,40,32,40,104,320
Saddiq Bey,SF,22,DET,54,54,1807,288,755,0.381,134,397,0.338,154,358,0.43,0.47,129,156,0.827,72,238,310,147,49,12,70,90,839
Khem Birch,C,29,TOR,27,7,508,51,106,0.481,0,8,0.0,51,98,0.52,0.481,33,44,0.75,64,61,125,30,19,12,17,42,135
Goga Bitadze,C,22,IND,32,5,359,58,131,0.443,8,45,0.178,50,86,0.581,0.473,29,46,0.63,44,47,91,19,12,21,25,55,153
Bismack Biyombo,C,29,PHO,15,3,290,54,89,0.607,0,0,,54,89,0.607,0.607,26,47,0.553,44,60,104,14,9,14,12,31,134
Nemanja Bjelica,C,33,GSW,49,0,755,115,254,0.453,40,117,0.342,75,137,0.547,0.531,44,62,0.71,42,157,199,90,31,17,57,80,314
Eric Bledsoe,PG,32,LAC,54,29,1361,197,468,0.421,51,163,0.313,146,305,0.479,0.475,89,117,0.761,28,154,182,225,69,19,116,85,534
Keljin Blevins,SF,26,POR,12,0,73,9,23,0.391,6,14,0.429,3,9,0.333,0.522,0,2,0.0,2,6,8,4,0,0,6,5,24
Bogdan Bogdanović,SG,29,ATL,36,26,1027,164,393,0.417,85,234,0.363,79,159,0.497,0.525,36,45,0.8,11,124,135,105,30,7,38,72,449
Bojan Bogdanović,PF,32,UTA,53,53,1641,325,708,0.459,129,338,0.382,196,370,0.53,0.55,175,201,0.871,44,187,231,91,25,1,87,91,954
Bol Bol,PF,22,DEN,14,0,81,15,27,0.556,1,4,0.25,14,23,0.609,0.574,2,5,0.4,4,16,20,5,1,2,4,4,33
Leandro Bolmaro,SF,21,MIN,25,2,188,9,32,0.281,2,12,0.167,7,20,0.35,0.313,8,9,0.889,15,20,35,11,5,0,12,21,28
Isaac Bonga,SF,22,TOR,13,0,66,3,13,0.231,1,4,0.25,2,9,0.222,0.269,4,6,0.667,4,3,7,3,7,2,2,10,11
Devin Booker,SG,25,PHO,47,47,1598,439,976,0.45,125,335,0.373,314,641,0.49,0.514,204,238,0.857,37,213,250,203,46,15,112,118,1207
Brandon Boston Jr.,SG,20,LAC,39,0,605,93,256,0.363,26,90,0.289,67,166,0.404,0.414,47,55,0.855,13,79,92,34,20,10,26,34,259
Chris Boucher,PF,29,TOR,51,8,1028,165,358,0.461,39,140,0.279,126,218,0.578,0.515,92,120,0.767,107,194,301,18,34,55,32,111,461
James Bouknight,SG,21,CHO,25,0,249,42,114,0.368,14,41,0.341,28,73,0.384,0.43,23,27,0.852,17,21,38,19,5,0,10,22,121
Avery Bradley,SG,31,LAL,48,41,1139,120,293,0.41,65,173,0.376,55,120,0.458,0.52,12,14,0.857,26,86,112,40,44,9,33,91,317
Tony Bradley,C,24,CHI,41,7,474,61,105,0.581,0,0,,61,105,0.581,0.581,14,20,0.7,54,101,155,21,10,28,26,54,136
Ignas Brazdeikis,SF,23,ORL,25,0,228,26,71,0.366,10,33,0.303,16,38,0.421,0.437,9,12,0.75,10,24,34,19,6,1,8,25,71
Mikal Bridges,SF,25,PHO,54,54,1877,281,538,0.522,75,203,0.369,206,335,0.615,0.592,70,80,0.875,55,176,231,117,66,25,42,102,707
Miles Bridges,PF,23,CHO,54,54,1941,400,825,0.485,98,316,0.31,302,509,0.593,0.544,173,217,0.797,63,322,385,192,57,50,98,143,1071
Oshae Brissett,SF,23,IND,43,1,822,96,238,0.403,36,108,0.333,60,130,0.462,0.479,48,73,0.658,56,132,188,31,25,13,31,60,276
Malcolm Brogdon,PG,29,IND,28,28,934,184,411,0.448,46,150,0.307,138,261,0.529,0.504,105,122,0.861,24,120,144,166,24,11,61,57,519
Armoni Brooks,SG,23,HOU,41,8,690,87,251,0.347,64,213,0.3,23,38,0.605,0.474,16,19,0.842,12,69,81,49,21,8,23,60,254
Dillon Brooks,SF,26,MEM,21,20,587,145,340,0.426,33,101,0.327,112,239,0.469,0.475,64,72,0.889,17,52,69,57,27,4,37,69,387
Bruce Brown,SF,25,BRK,45,19,924,115,241,0.477,11,37,0.297,104,204,0.51,0.5,31,42,0.738,55,137,192,53,42,23,31,106,272
Charlie Brown Jr.,SG,24,TOT,17,2,166,9,36,0.25,1,12,0.083,8,24,0.333,0.264,7,8,0.875,14,17,31,5,9,4,5,18,26
Chaundee Brown Jr.,SG-SF,23,TOT,5,2,104,10,32,0.313,6,18,0.333,4,14,0.286,0.406,5,6,0.833,1,15,16,4,2,0,1,7,31
Greg Brown III,SF,20,POR,25,0,173,32,70,0.457,4,19,0.211,28,51,0.549,0.486,17,28,0.607,16,28,44,6,6,7,9,21,85
Jaylen Brown,SF,25,BOS,42,42,1435,366,794,0.461,112,321,0.349,254,473,0.537,0.531,159,203,0.783,34,241,275,134,45,15,123,109,1003
Moses Brown,C,22,DAL,26,1,169,27,50,0.54,0,0,,27,50,0.54,0.54,27,43,0.628,16,45,61,1,3,9,14,28,81
Sterling Brown,SG,26,DAL,36,3,513,51,128,0.398,27,79,0.342,24,49,0.49,0.504,10,11,0.909,22,104,126,29,12,5,21,43,139
Troy Brown Jr.,SF,22,CHI,44,5,782,81,188,0.431,32,91,0.352,49,97,0.505,0.516,19,25,0.76,29,114,143,52,26,4,20,49,213
Jalen Brunson,PG,25,DAL,54,36,1708,350,690,0.507,57,161,0.354,293,529,0.554,0.549,111,137,0.81,30,176,206,295,49,3,93,101,868
Thomas Bryant,C,24,WAS,11,4,177,28,62,0.452,7,21,0.333,21,41,0.512,0.508,13,17,0.765,11,26,37,6,3,5,8,19,76
Shaq Buchanan,PG,25,MEM,2,0,10,1,4,0.25,0,2,0.0,1,2,0.5,0.25,0,0,,1,1,2,2,1,0,2,1,2
Reggie Bullock,SF,30,DAL,47,16,1164,130,316,0.411,86,240,0.358,44,76,0.579,0.547,27,32,0.844,20,141,161,49,25,6,25,62,373
Trey Burke,PG,29,DAL,30,0,334,70,165,0.424,23,66,0.348,47,99,0.475,0.494,16,17,0.941,3,25,28,45,10,0,21,30,179
Alec Burks,SG,30,NYK,54,21,1445,179,468,0.382,95,245,0.388,84,223,0.377,0.484,144,173,0.832,33,199,232,137,60,15,53,128,597
Jared Butler,SG,21,UTA,26,1,206,35,86,0.407,16,45,0.356,19,41,0.463,0.5,7,12,0.583,3,19,22,29,8,7,22,27,93
Jimmy Butler,SF,32,MIA,36,36,1215,260,529,0.491,14,66,0.212,246,463,0.531,0.505,250,281,0.89,67,156,223,223,65,16,75,52,784
Devontae Cacok,PF,25,SAS,8,0,67,16,23,0.696,0,0,,16,23,0.696,0.696,4,7,0.571,5,22,27,2,4,7,1,8,36
Kentavious Caldwell-Pope,SG,28,WAS,50,50,1461,202,500,0.404,96,261,0.368,106,239,0.444,0.5,63,71,0.887,23,147,170,85,52,19,60,85,563
Facundo Campazzo,PG,30,DEN,51,4,1024,97,255,0.38,51,163,0.313,46,92,0.5,0.48,53,66,0.803,17,78,95,190,54,20,60,103,298
Vlatko Čančar,PF,24,DEN,14,1,152,22,39,0.564,7,12,0.583,15,27,0.556,0.654,9,12,0.75,6,17,23,13,2,3,8,13,60
Clint Capela,C,27,ATL,46,45,1295,225,388,0.58,0,1,0.0,225,387,0.581,0.58,51,112,0.455,176,383,559,66,35,62,25,106,501
Vernon Carey Jr.,C,20,CHO,4,1,17,3,6,0.5,0,0,,3,6,0.5,0.5,2,3,0.667,3,2,5,0,1,0,1,1,8
Jevon Carter,PG,26,BRK,41,1,484,48,147,0.327,36,106,0.34,12,41,0.293,0.449,6,8,0.75,7,50,57,40,14,10,19,41,138
Wendell Carter Jr.,C,22,ORL,47,46,1376,243,482,0.504,55,167,0.329,188,315,0.597,0.561,103,144,0.715,96,382,478,125,30,33,80,128,644
Alex Caruso,SG,27,CHI,28,9,775,78,182,0.429,30,87,0.345,48,95,0.505,0.511,48,59,0.814,25,83,108,109,54,11,40,68,234
Willie Cauley-Stein,C,28,DAL,18,2,177,16,35,0.457,1,2,0.5,15,33,0.455,0.471,1,2,0.5,13,25,38,9,6,3,7,17,34
Ahmad Caver,PG,25,IND,1,0,1,1,1,1.0,0,0,,1,1,1.0,1.0,0,0,,0,0,0,0,0,0,0,0,2
Justin Champagnie,SF,20,TOR,30,0,252,29,60,0.483,9,22,0.409,20,38,0.526,0.558,9,9,1.0,37,27,64,9,7,4,7,32,76
Zylan Cheatham,SF,26,UTA,1,0,5,0,3,0.0,0,2,0.0,0,1,0.0,0.0,0,0,,0,0,0,0,0,0,0,0,0
Chris Chiozza,PG,26,GSW,26,1,279,19,65,0.292,16,43,0.372,3,22,0.136,0.415,1,1,1.0,8,22,30,47,9,0,22,24,55
Marquese Chriss,PF,24,DAL,22,0,251,48,98,0.49,7,20,0.35,41,78,0.526,0.526,12,19,0.632,20,58,78,12,11,10,17,49,115
Josh Christopher,SG,20,HOU,46,2,765,132,281,0.47,36,107,0.336,96,174,0.552,0.534,49,64,0.766,31,62,93,81,39,6,67,50,349
Gary Clark,PF,27,NOP,22,1,241,20,55,0.364,17,45,0.378,3,10,0.3,0.518,4,6,0.667,14,39,53,8,7,6,5,14,61
Brandon Clarke,PF,25,MEM,41,1,766,178,272,0.654,4,18,0.222,174,254,0.685,0.662,54,76,0.711,79,135,214,58,19,44,20,69,414
Jordan Clarkson,SG,29,UTA,52,1,1381,292,729,0.401,134,418,0.321,158,311,0.508,0.492,86,105,0.819,41,137,178,124,36,13,86,99,804
Nic Claxton,C,22,BRK,25,18,530,99,155,0.639,0,0,,99,155,0.639,0.639,30,53,0.566,55,85,140,21,12,28,18,56,228
Amir Coffey,SG,24,LAC,43,20,949,121,261,0.464,62,156,0.397,59,105,0.562,0.582,63,71,0.887,21,111,132,69,22,10,21,55,367
John Collins,PF,24,ATL,49,49,1543,323,597,0.541,62,157,0.395,261,440,0.593,0.593,127,160,0.794,88,306,394,93,32,54,54,150,835
Zach Collins,PF,24,SAS,2,0,31,6,13,0.462,1,2,0.5,5,11,0.455,0.5,2,4,0.5,7,7,14,6,3,0,4,6,15
Darren Collison,PG,34,LAL,3,0,37,2,7,0.286,0,3,0.0,2,4,0.5,0.286,0,0,,0,4,4,2,1,0,1,5,4
Mike Conley,PG,34,UTA,49,49,1395,243,541,0.449,121,285,0.425,122,256,0.477,0.561,96,115,0.835,30,120,150,256,58,14,83,90,703
Pat Connaughton,SG,29,MIL,53,18,1441,193,408,0.473,124,300,0.413,69,108,0.639,0.625,30,37,0.811,37,197,234,66,50,14,31,72,540
Tyler Cook,PF,24,CHI,18,2,192,22,36,0.611,0,0,,22,36,0.611,0.611,20,31,0.645,16,35,51,3,4,4,7,24,64
Sharife Cooper,PG,20,ATL,10,0,35,3,14,0.214,1,6,0.167,2,8,0.25,0.25,0,0,,0,5,5,5,0,0,5,1,7
Petr Cornelie,PF,26,DEN,13,0,38,5,15,0.333,1,8,0.125,4,7,0.571,0.367,3,4,0.75,7,7,14,3,1,1,4,7,14
DeMarcus Cousins,C,31,TOT,22,5,353,64,153,0.418,16,61,0.262,48,92,0.522,0.471,40,52,0.769,34,99,133,23,20,9,29,61,184
Robert Covington,PF-SF,31,TOT,50,40,1483,136,353,0.385,83,240,0.346,53,113,0.469,0.503,37,45,0.822,45,239,284,69,76,65,61,138,392
Torrey Craig,SF,31,IND,51,14,1034,128,281,0.456,46,138,0.333,82,143,0.573,0.537,27,35,0.771,59,136,195,58,24,19,39,95,329
Jae Crowder,PF,31,PHO,44,44,1244,136,343,0.397,79,230,0.343,57,113,0.504,0.512,40,49,0.816,18,212,230,66,55,21,39,106,391
Jarrett Culver,SG,22,MEM,25,0,233,37,89,0.416,9,30,0.3,28,59,0.475,0.466,11,21,0.524,8,29,37,25,14,3,11,26,94
Jarron Cumberland,SG,24,POR,3,0,12,1,2,0.5,0,1,0.0,1,1,1.0,0.5,0,0,,1,2,3,1,0,0,0,2,2
Cade Cunningham,PG,20,DET,41,41,1314,245,617,0.397,84,256,0.328,161,361,0.446,0.465,74,86,0.86,38,186,224,215,54,28,143,121,648
Seth Curry,SG,31,PHI,45,45,1566,256,528,0.485,100,250,0.4,156,278,0.561,0.58,64,73,0.877,17,134,151,181,36,11,84,101,676
Stephen Curry,PG,33,GSW,50,50,1732,413,979,0.422,236,619,0.381,177,360,0.492,0.542,214,235,0.911,31,243,274,316,72,21,164,102,1276
Anthony Davis,C,28,LAL,35,35,1245,329,613,0.537,11,64,0.172,318,549,0.579,0.546,153,215,0.712,101,250,351,101,44,81,76,89,822
Ed Davis,C,32,CLE,18,3,139,9,14,0.643,0,0,,9,14,0.643,0.643,3,8,0.375,7,36,43,3,3,7,5,26,21
Terence Davis,SG,24,SAC,30,11,536,113,267,0.423,49,149,0.329,64,118,0.542,0.515,36,44,0.818,11,83,94,40,25,11,33,70,311
Gabriel Deck,PF,26,OKC,7,0,56,8,14,0.571,2,4,0.5,6,10,0.6,0.643,0,0,,1,5,6,5,1,0,2,2,18
Dewayne Dedmon,C,32,MIA,48,15,792,124,213,0.582,15,28,0.536,109,185,0.589,0.617,50,64,0.781,87,209,296,37,20,25,52,114,313
Sam Dekker,PF,27,TOR,1,0,1,0,0,,0,0,,0,0,,,0,0,,0,0,0,0,0,0,0,0,0
Javin DeLaurier,C,23,MIL,1,0,3,0,0,,0,0,,0,0,,,0,0,,0,1,1,0,1,0,0,1,0
DeMar DeRozan,PF,32,CHI,51,51,1807,508,997,0.51,33,96,0.344,475,901,0.527,0.526,347,404,0.859,44,222,266,259,44,17,120,113,1396
Mamadi Diakite,PF,25,OKC,13,3,188,25,47,0.532,0,5,0.0,25,42,0.595,0.532,6,11,0.545,17,42,59,2,5,9,7,33,56
Cheick Diallo,C,25,DET,3,0,31,3,8,0.375,0,0,,3,8,0.375,0.375,5,6,0.833,4,8,12,0,1,0,1,6,11
Hamidou Diallo,SG,23,DET,47,28,1055,212,427,0.496,19,76,0.25,193,351,0.55,0.519,72,108,0.667,59,165,224,57,57,15,48,122,515
Gorgui Dieng,C,32,ATL,35,3,323,43,91,0.473,21,50,0.42,22,41,0.537,0.588,17,23,0.739,31,78,109,28,9,12,19,45,124
Spencer Dinwiddie,PG,28,WAS,44,44,1330,185,492,0.376,70,226,0.31,115,266,0.432,0.447,116,143,0.811,36,171,207,256,27,7,73,107,556
Donte DiVincenzo,SG,25,MIL,17,0,341,39,118,0.331,21,74,0.284,18,44,0.409,0.419,23,27,0.852,18,42,60,29,11,3,28,26,122
Luka Dončić,PG,22,DAL,40,40,1403,374,840,0.445,100,316,0.316,274,524,0.523,0.505,198,269,0.736,36,319,355,367,49,19,172,94,1046
Luguentz Dort,SF,22,OKC,49,49,1601,279,690,0.404,124,374,0.332,155,316,0.491,0.494,149,175,0.851,38,168,206,86,45,18,86,143,831
Ayo Dosunmu,SG,22,CHI,50,16,1237,154,298,0.517,45,110,0.409,109,188,0.58,0.592,37,56,0.661,16,114,130,137,31,18,58,107,390
Damyean Dotson,SG,27,NYK,2,0,21,2,4,0.5,0,1,0.0,2,3,0.667,0.5,0,0,,0,2,2,1,0,0,0,0,4
Devon Dotson,PG,22,CHI,11,0,85,11,23,0.478,2,9,0.222,9,14,0.643,0.522,5,9,0.556,1,8,9,15,1,0,5,11,29
Sekou Doumbouya,PF,21,LAL,2,0,16,5,8,0.625,1,2,0.5,4,6,0.667,0.688,3,4,0.75,2,4,6,0,3,2,2,1,14
Jeff Dowtin,PG,24,TOT,5,0,31,3,7,0.429,0,2,0.0,3,5,0.6,0.429,0,0,,1,6,7,3,0,1,1,2,6
PJ Dozier,SG,25,DEN,18,0,340,36,99,0.364,15,48,0.313,21,51,0.412,0.439,10,13,0.769,14,49,63,29,11,6,13,33,97
Goran Dragić,PG,35,TOR,5,2,90,13,34,0.382,4,14,0.286,9,20,0.45,0.441,10,10,1.0,2,12,14,9,5,1,1,8,40
Andre Drummond,C,28,PHI,49,12,902,128,238,0.538,0,2,0.0,128,236,0.542,0.538,42,82,0.512,136,297,433,97,56,45,79,121,298
Chris Duarte,SG,24,IND,48,36,1392,244,561,0.435,83,231,0.359,161,330,0.488,0.509,80,101,0.792,34,166,200,107,51,10,79,80,651
David Duke Jr.,PG,22,BRK,15,7,273,34,91,0.374,8,31,0.258,26,60,0.433,0.418,16,19,0.842,28,32,60,15,11,6,8,29,92
Kevin Durant,PF,33,BRK,36,36,1313,379,729,0.52,67,180,0.372,312,549,0.568,0.566,228,255,0.894,20,247,267,207,28,34,107,68,1053
Jaime Echenique,C,24,WAS,1,0,3,0,0,,0,0,,0,0,,,0,0,,0,0,0,0,0,0,0,0,0
Anthony Edwards,SG,20,MIN,49,49,1708,387,888,0.436,152,426,0.357,235,462,0.509,0.521,150,186,0.806,45,190,235,175,74,34,138,115,1076
Kessler Edwards,SF,21,BRK,23,16,588,65,153,0.425,28,75,0.373,37,78,0.474,0.516,6,8,0.75,27,74,101,16,19,15,26,46,164
Rob Edwards,SG,25,OKC,2,0,11,1,4,0.25,1,4,0.25,0,0,,0.375,0,0,,0,3,3,0,0,0,1,0,3
CJ Elleby,SF,21,POR,32,4,441,51,124,0.411,16,52,0.308,35,72,0.486,0.476,17,20,0.85,27,62,89,34,17,5,15,47,135
Wayne Ellington,SG,34,LAL,34,9,657,73,183,0.399,65,166,0.392,8,17,0.471,0.577,4,5,0.8,9,49,58,24,18,2,15,34,215
Joel Embiid,C,27,PHI,42,42,1384,403,810,0.498,54,151,0.358,349,659,0.53,0.531,375,462,0.812,84,374,458,182,42,60,120,109,1235
James Ennis III,SF,31,TOT,7,0,56,11,24,0.458,3,8,0.375,8,16,0.5,0.521,4,5,0.8,5,7,12,3,2,2,2,5,29
Drew Eubanks,C,24,SAS,49,9,595,84,159,0.528,1,8,0.125,83,151,0.55,0.531,59,79,0.747,64,132,196,50,13,30,46,61,228
Tacko Fall,C,26,CLE,11,1,59,5,12,0.417,0,0,,5,12,0.417,0.417,2,7,0.286,7,16,23,2,0,6,3,3,12
Derrick Favors,C,30,OKC,35,16,575,78,157,0.497,2,13,0.154,76,144,0.528,0.503,14,22,0.636,51,113,164,24,14,8,7,54,172
Bruno Fernando,C,23,BOS,20,0,58,7,14,0.5,1,1,1.0,6,13,0.462,0.536,4,5,0.8,7,8,15,4,0,3,5,6,19
Dorian Finney-Smith,PF,28,DAL,54,54,1753,200,460,0.435,101,278,0.363,99,182,0.544,0.545,44,64,0.688,86,175,261,106,64,28,57,120,545
Malik Fitts,PF,24,UTA,7,0,35,2,9,0.222,2,4,0.5,0,5,0.0,0.333,0,0,,0,10,10,0,0,0,2,3,6
Malachi Flynn,PG,23,TOR,31,1,268,35,96,0.365,14,50,0.28,21,46,0.457,0.438,6,9,0.667,6,25,31,30,11,3,9,27,90
Bryn Forbes,SG,28,TOT,51,1,901,169,398,0.425,82,200,0.41,87,198,0.439,0.528,52,58,0.897,6,70,76,55,18,3,39,64,472
Aleem Ford,SF,24,ORL,5,0,74,6,20,0.3,2,15,0.133,4,5,0.8,0.35,0,0,,2,13,15,2,1,0,4,7,14
Trent Forrest,PG,23,UTA,43,4,514,53,96,0.552,3,15,0.2,50,81,0.617,0.568,25,32,0.781,15,58,73,62,20,3,34,32,134
Evan Fournier,SG,29,NYK,53,53,1538,274,638,0.429,154,383,0.402,120,255,0.471,0.55,53,74,0.716,29,129,158,95,50,13,72,112,755
De'Aaron Fox,PG,24,SAC,45,45,1540,359,780,0.46,45,167,0.269,314,613,0.512,0.489,197,263,0.749,21,156,177,231,53,19,125,128,960
Tim Frazier,PG,31,ORL,10,3,200,13,43,0.302,6,17,0.353,7,26,0.269,0.372,5,9,0.556,5,14,19,33,3,1,13,24,37
Enes Freedom,C,29,BOS,35,1,411,51,97,0.526,2,5,0.4,49,92,0.533,0.536,24,28,0.857,61,99,160,8,5,14,20,42,128
Wenyen Gabriel,PF,24,TOT,7,0,47,5,13,0.385,2,5,0.4,3,8,0.375,0.462,2,4,0.5,5,10,15,2,1,2,3,11,14
Daniel Gafford,C,23,WAS,48,46,988,181,267,0.678,0,0,,181,267,0.678,0.678,65,86,0.756,108,180,288,48,19,74,44,113,427
Danilo Gallinari,PF,33,ATL,43,1,997,139,330,0.421,67,173,0.387,72,157,0.459,0.523,95,104,0.913,22,168,190,61,20,9,26,64,440
Langston Galloway,SG,30,TOT,7,0,107,6,26,0.231,2,16,0.125,4,10,0.4,0.269,0,0,,3,15,18,12,1,0,6,7,14
Darius Garland,PG,22,CLE,45,45,1556,342,721,0.474,114,304,0.375,228,417,0.547,0.553,98,108,0.907,23,127,150,365,55,4,166,77,896
Marcus Garrett,SG,23,MIA,12,0,128,5,21,0.238,1,4,0.25,4,17,0.235,0.262,2,5,0.4,9,14,23,7,5,3,2,16,13
Usman Garuba,PF,19,HOU,15,0,105,8,24,0.333,2,13,0.154,6,11,0.545,0.375,1,2,0.5,9,25,34,8,7,6,3,9,19
Luka Garza,C,23,DET,27,5,327,51,117,0.436,13,40,0.325,38,77,0.494,0.491,27,42,0.643,47,36,83,15,8,4,16,46,142
Rudy Gay,PF,35,UTA,35,1,699,107,256,0.418,49,144,0.34,58,112,0.518,0.514,49,62,0.79,35,127,162,39,20,12,30,66,312
Paul George,SF,31,LAC,26,26,924,234,556,0.421,70,217,0.323,164,339,0.484,0.484,103,117,0.88,11,174,185,142,53,10,109,65,641
Taj Gibson,C,36,NYK,35,4,627,49,95,0.516,6,18,0.333,43,77,0.558,0.547,23,31,0.742,53,96,149,23,16,28,22,95,127
Josh Giddey,SG,19,OKC,49,49,1535,249,598,0.416,50,198,0.253,199,400,0.498,0.458,46,66,0.697,87,285,372,302,47,19,150,82,594
Shai Gilgeous-Alexander,PG,23,OKC,43,43,1487,334,788,0.424,67,241,0.278,267,547,0.488,0.466,241,297,0.811,30,173,203,236,49,34,103,100,976
Anthony Gill,PF,29,WAS,21,0,121,18,27,0.667,5,7,0.714,13,20,0.65,0.759,12,14,0.857,8,17,25,8,1,3,5,19,53
Freddie Gillespie,PF,24,ORL,9,2,119,9,22,0.409,0,1,0.0,9,21,0.429,0.409,3,7,0.429,13,23,36,5,3,9,5,18,21
Rudy Gobert,C,29,UTA,42,42,1364,237,335,0.707,0,2,0.0,237,333,0.712,0.707,196,284,0.69,154,479,633,49,33,95,77,112,670
Brandon Goodwin,PG,26,CLE,15,3,251,33,85,0.388,12,32,0.375,21,53,0.396,0.459,7,14,0.5,7,30,37,49,16,0,17,22,85
Jordan Goodwin,SG,23,WAS,2,0,6,0,3,0.0,0,1,0.0,0,2,0.0,0.0,0,0,,0,1,1,0,0,0,0,1,0
Aaron Gordon,PF,26,DEN,49,49,1555,277,533,0.52,58,172,0.337,219,361,0.607,0.574,107,146,0.733,84,195,279,127,32,28,85,90,719
Eric Gordon,SG,33,HOU,45,34,1326,225,458,0.491,100,234,0.427,125,224,0.558,0.6,87,115,0.757,13,76,89,137,23,16,90,46,637
Devonte' Graham,PG,26,NOP,50,50,1563,223,614,0.363,145,417,0.348,78,197,0.396,0.481,87,103,0.845,22,104,126,227,47,8,79,70,678
Jerami Grant,PF,27,DET,29,29,945,182,450,0.404,51,154,0.331,131,296,0.443,0.461,139,167,0.832,23,108,131,73,28,30,59,65,554
Hassani Gravett,PG,25,ORL,8,3,171,18,38,0.474,11,26,0.423,7,12,0.583,0.618,3,4,0.75,1,20,21,20,5,1,9,13,50
Danny Green,SF,34,PHI,36,23,842,84,204,0.412,66,171,0.386,18,33,0.545,0.574,9,10,0.9,19,73,92,36,41,27,34,62,243
Draymond Green,PF,31,GSW,34,34,1018,108,201,0.537,12,42,0.286,96,159,0.604,0.567,40,67,0.597,38,219,257,250,47,41,106,94,268
Jalen Green,SG,19,HOU,39,39,1178,185,491,0.377,69,238,0.29,116,253,0.458,0.447,119,142,0.838,16,114,130,94,23,6,89,57,558
JaMychal Green,PF,31,DEN,41,7,604,92,200,0.46,23,87,0.264,69,113,0.611,0.518,48,55,0.873,38,110,148,35,30,17,36,92,255
Javonte Green,SF,28,CHI,39,28,922,101,192,0.526,15,53,0.283,86,139,0.619,0.565,59,72,0.819,61,104,165,44,36,22,20,84,276
Jeff Green,C,35,DEN,50,38,1228,187,364,0.514,36,112,0.321,151,252,0.599,0.563,103,126,0.817,28,129,157,59,15,21,46,111,513
Josh Green,SG,21,DAL,40,0,553,72,139,0.518,10,32,0.313,62,107,0.579,0.554,25,35,0.714,27,56,83,51,26,8,20,64,179
Blake Griffin,PF,32,BRK,43,22,799,109,264,0.413,28,122,0.23,81,142,0.57,0.466,44,60,0.733,51,141,192,92,23,12,21,79,290
Quentin Grimes,SG,21,NYK,35,2,556,70,172,0.407,52,136,0.382,18,36,0.5,0.558,8,11,0.727,16,45,61,33,23,6,22,47,200
Kyle Guy,SG,24,MIA,14,0,175,26,60,0.433,14,35,0.4,12,25,0.48,0.55,7,10,0.7,2,11,13,17,7,1,12,12,73
Rui Hachimura,PF,23,WAS,14,0,250,41,94,0.436,11,29,0.379,30,65,0.462,0.495,16,21,0.762,5,46,51,13,4,3,9,14,109
Tyrese Haliburton,SG,21,SAC,51,51,1757,268,586,0.457,104,252,0.413,164,334,0.491,0.546,87,104,0.837,39,160,199,379,86,34,115,71,727
Tyler Hall,SG,24,NYK,1,0,2,0,0,,0,0,,0,0,,,0,0,,0,0,0,0,0,0,0,0,0
R.J. Hampton,SG,20,ORL,42,1,815,107,280,0.382,39,107,0.364,68,173,0.393,0.452,48,79,0.608,14,108,122,102,29,8,56,62,301
Tim Hardaway Jr.,SG,29,DAL,42,20,1245,209,530,0.394,102,304,0.336,107,226,0.473,0.491,78,103,0.757,13,143,156,92,38,6,34,74,598
James Harden,PG,32,BRK,44,44,1627,292,706,0.414,102,307,0.332,190,399,0.476,0.486,304,350,0.869,42,309,351,447,56,31,212,105,990
Maurice Harkless,SF,28,SAC,38,19,737,72,162,0.444,27,91,0.297,45,71,0.634,0.528,15,21,0.714,12,81,93,22,24,22,27,64,186
Jared Harper,PG,24,NOP,2,0,10,3,7,0.429,1,2,0.5,2,5,0.4,0.5,0,0,,1,0,1,3,0,1,1,2,7
Montrezl Harrell,C,28,WAS,46,3,1117,247,383,0.645,4,15,0.267,243,368,0.66,0.65,149,205,0.727,96,213,309,96,18,31,50,88,647
Gary Harris,SG,27,ORL,48,30,1416,202,455,0.444,92,237,0.388,110,218,0.505,0.545,65,77,0.844,30,75,105,91,40,8,50,92,561
Joe Harris,SF,30,BRK,14,14,423,56,124,0.452,41,88,0.466,15,36,0.417,0.617,5,6,0.833,5,51,56,14,7,2,16,31,158
Tobias Harris,PF,29,PHI,45,45,1595,334,684,0.488,54,156,0.346,280,528,0.53,0.528,139,163,0.853,50,280,330,170,29,28,83,92,861
Shaquille Harrison,SG,28,BRK,2,0,23,2,6,0.333,0,2,0.0,2,4,0.5,0.333,0,0,,1,3,4,3,1,1,2,3,4
Josh Hart,PF,26,NOP,41,40,1374,195,386,0.505,42,130,0.323,153,256,0.598,0.56,116,154,0.753,53,265,318,168,45,11,81,118,548
Isaiah Hartenstein,C,23,LAC,42,0,674,133,213,0.624,3,6,0.5,130,207,0.628,0.631,49,72,0.681,66,114,180,78,30,46,44,104,318
Udonis Haslem,C,41,MIA,9,0,57,11,22,0.5,1,2,0.5,10,20,0.5,0.523,3,3,1.0,4,14,18,3,1,1,3,11,26
Sam Hauser,SF,24,BOS,10,0,41,4,14,0.286,4,14,0.286,0,0,,0.429,0,0,,1,5,6,1,1,1,0,4,12
Jaxson Hayes,C,21,NOP,42,4,688,133,211,0.63,7,25,0.28,126,186,0.677,0.647,81,105,0.771,57,112,169,20,17,32,32,94,354
Killian Hayes,PG,20,DET,42,33,1052,100,274,0.365,30,108,0.278,70,166,0.422,0.42,38,47,0.809,19,106,125,166,45,23,71,108,268
Gordon Hayward,SF,31,CHO,48,48,1547,281,611,0.46,85,218,0.39,196,393,0.499,0.529,126,149,0.846,38,183,221,173,46,22,80,85,773
Aaron Henry,SF,22,PHI,6,0,17,1,5,0.2,0,1,0.0,1,4,0.25,0.2,0,0,,0,1,1,0,0,2,2,2,2
Juancho Hernangómez,PF,26,TOT,23,0,147,7,33,0.212,3,21,0.143,4,12,0.333,0.258,9,13,0.692,13,27,40,6,5,3,8,7,26
Willy Hernangómez,C,27,NOP,28,6,467,98,183,0.536,3,7,0.429,95,176,0.54,0.544,58,77,0.753,78,121,199,37,10,9,28,52,257
Tyler Herro,SG,22,MIA,45,10,1480,336,785,0.428,116,307,0.378,220,478,0.46,0.502,117,134,0.873,27,188,215,180,29,8,126,69,905
Buddy Hield,SG,29,SAC,55,6,1574,265,693,0.382,182,495,0.368,83,198,0.419,0.514,80,92,0.87,43,178,221,105,48,15,90,113,792
Haywood Highsmith,SF,25,MIA,4,0,42,4,8,0.5,4,7,0.571,0,1,0.0,0.75,0,0,,2,3,5,0,0,1,0,3,12
George Hill,SG,35,MIL,41,16,1044,102,234,0.436,37,117,0.316,65,117,0.556,0.515,48,50,0.96,35,97,132,101,33,6,35,57,289
Malcolm Hill,SF-SG,26,TOT,14,0,176,21,43,0.488,12,29,0.414,9,14,0.643,0.628,10,12,0.833,10,17,27,4,6,3,2,20,64
Solomon Hill,PF,30,ATL,13,1,139,3,20,0.15,2,13,0.154,1,7,0.143,0.2,0,0,,6,17,23,12,4,2,1,16,8
Nate Hinton,SG,22,IND,2,0,2,0,1,0.0,0,0,,0,1,0.0,0.0,0,0,,0,0,0,0,0,0,1,0,0
Jaylen Hoard,SF,22,OKC,1,0,2,0,1,0.0,0,0,,0,1,0.0,0.0,0,0,,1,1,2,0,0,0,0,0,0
Aaron Holiday,PG,25,WAS,41,14,663,100,214,0.467,23,67,0.343,77,147,0.524,0.521,28,35,0.8,9,58,67,78,24,9,39,60,251
Jrue Holiday,PG,31,MIL,43,40,1408,308,612,0.503,77,195,0.395,231,417,0.554,0.566,76,100,0.76,41,160,201,288,65,24,115,80,769
Justin Holiday,SF-SG,32,TOT,50,41,1446,192,469,0.409,127,342,0.371,65,127,0.512,0.545,36,43,0.837,19,118,137,94,38,19,54,107,547
Richaun Holmes,C,28,SAC,38,37,963,186,272,0.684,2,5,0.4,184,267,0.689,0.688,65,85,0.765,85,209,294,46,16,37,50,115,439
Rodney Hood,SF,29,MIL,39,0,581,46,131,0.351,24,80,0.3,22,51,0.431,0.443,13,14,0.929,13,54,67,30,12,4,7,27,129
Scotty Hopson,SG,32,OKC,1,0,18,2,4,0.5,0,1,0.0,2,3,0.667,0.5,0,0,,0,1,1,1,0,0,2,1,4
Al Horford,C,35,BOS,47,47,1335,177,407,0.435,55,188,0.293,122,219,0.557,0.502,63,75,0.84,75,276,351,161,28,61,48,90,472
Talen Horton-Tucker,SG,21,LAL,40,15,1028,144,351,0.41,32,119,0.269,112,232,0.483,0.456,59,74,0.797,23,106,129,106,37,19,61,99,379
Danuel House Jr.,SF,28,TOT,24,2,371,44,114,0.386,20,59,0.339,24,55,0.436,0.474,27,33,0.818,8,53,61,30,10,8,22,25,135
Dwight Howard,C,36,LAL,41,11,594,77,124,0.621,6,9,0.667,71,115,0.617,0.645,52,85,0.612,79,144,223,22,28,25,33,80,212
Markus Howard,SG,22,DEN,22,0,134,27,73,0.37,23,53,0.434,4,20,0.2,0.527,13,14,0.929,0,6,6,6,7,0,6,11,90
Kevin Huerter,SG,23,ATL,47,33,1367,213,460,0.463,89,236,0.377,124,224,0.554,0.56,28,35,0.8,20,129,149,133,28,14,63,104,543
Jay Huff,C,23,LAL,4,0,20,0,3,0.0,0,2,0.0,0,1,0.0,0.0,0,0,,1,3,4,1,1,1,1,1,0
Elijah Hughes,SF,23,UTA,14,1,112,15,36,0.417,10,28,0.357,5,8,0.625,0.556,3,3,1.0,2,15,17,6,4,1,7,7,43
De'Andre Hunter,SF,24,ATL,26,25,747,124,274,0.453,37,91,0.407,87,183,0.475,0.52,54,77,0.701,10,79,89,33,16,10,38,74,339
Chandler Hutchison,SF,25,PHO,6,0,22,1,2,0.5,0,0,,1,2,0.5,0.5,2,2,1.0,0,5,5,2,0,0,4,1,4
Bones Hyland,PG,21,DEN,42,0,742,122,333,0.366,71,204,0.348,51,129,0.395,0.473,48,54,0.889,7,106,113,82,20,13,49,87,363
Serge Ibaka,C,32,LAC,35,10,538,94,192,0.49,24,62,0.387,70,130,0.538,0.552,20,29,0.69,40,110,150,36,7,26,33,56,232
Andre Iguodala,SF,38,GSW,26,0,518,40,102,0.392,14,61,0.23,26,41,0.634,0.461,13,16,0.813,19,67,86,99,22,21,23,25,107
Joe Ingles,SF,34,UTA,45,15,1122,115,285,0.404,78,225,0.347,37,60,0.617,0.54,17,22,0.773,12,119,131,158,23,5,46,82,325
Brandon Ingram,SF,24,NOP,40,40,1379,333,740,0.45,63,181,0.348,270,559,0.483,0.493,187,228,0.82,28,203,231,218,27,19,105,80,916
Kyrie Irving,PG,29,BRK,12,12,427,108,237,0.456,29,79,0.367,79,158,0.5,0.517,33,36,0.917,8,49,57,64,13,7,29,28,278
Wes Iwundu,SF,27,ATL,3,1,82,8,18,0.444,3,5,0.6,5,13,0.385,0.528,3,4,0.75,3,10,13,0,1,0,1,8,22
Frank Jackson,PG,23,DET,41,5,931,162,384,0.422,75,227,0.33,87,157,0.554,0.52,57,72,0.792,14,54,68,39,20,9,32,72,456
Isaiah Jackson,PF,20,IND,19,2,181,40,76,0.526,3,7,0.429,37,69,0.536,0.546,21,31,0.677,23,31,54,7,8,15,10,35,104
Jaren Jackson Jr.,PF,22,MEM,55,55,1536,319,753,0.424,94,296,0.318,225,457,0.492,0.486,194,242,0.802,82,246,328,58,56,123,93,185,926
Josh Jackson,SF,24,DET,39,3,707,103,251,0.41,30,113,0.265,73,138,0.529,0.47,40,56,0.714,17,106,123,49,21,18,38,71,276
Justin Jackson,SF,26,TOT,7,0,37,5,15,0.333,3,9,0.333,2,6,0.333,0.433,2,2,1.0,1,6,7,2,0,0,1,3,15
Reggie Jackson,SG,31,LAC,52,52,1586,322,818,0.394,123,372,0.331,199,446,0.446,0.469,90,105,0.857,25,149,174,212,39,6,113,100,857
LeBron James,SF,37,LAL,39,39,1430,430,818,0.526,108,305,0.354,322,513,0.628,0.592,165,219,0.753,42,259,301,252,63,40,124,88,1133
DeJon Jarreau,SG,24,IND,1,0,1,0,0,,0,0,,0,0,,,0,0,,0,0,0,0,0,0,0,0,0
DaQuan Jeffries,SG,24,MEM,3,0,9,1,2,0.5,0,1,0.0,1,1,1.0,0.5,0,0,,0,2,2,1,0,0,0,1,2
Ty Jerome,SG,24,OKC,45,4,745,119,308,0.386,51,174,0.293,68,134,0.507,0.469,35,42,0.833,18,54,72,98,28,5,34,70,324
Isaiah Joe,SG,22,PHI,38,1,491,49,138,0.355,35,106,0.33,14,32,0.438,0.482,20,21,0.952,5,40,45,28,10,2,13,38,153
Alize Johnson,PF,25,TOT,19,0,139,14,29,0.483,0,4,0.0,14,25,0.56,0.483,4,8,0.5,21,27,48,8,3,0,11,15,32
B.J. Johnson,SF,26,ORL,4,0,65,11,25,0.44,4,10,0.4,7,15,0.467,0.52,0,0,,6,9,15,0,0,1,0,4,26
Cameron Johnson,PF,25,PHO,51,10,1327,208,456,0.456,127,296,0.429,81,160,0.506,0.595,62,73,0.849,30,184,214,63,44,12,31,88,605
David Johnson,SG,20,TOR,2,0,2,0,1,0.0,0,1,0.0,0,0,,0.0,0,0,,0,0,0,0,0,0,0,0,0
Jalen Johnson,PF,20,ATL,13,0,58,9,19,0.474,3,7,0.429,6,12,0.5,0.553,4,6,0.667,0,15,15,1,0,0,3,3,25
James Johnson,PF,34,BRK,39,5,735,95,196,0.485,13,46,0.283,82,150,0.547,0.518,11,29,0.379,38,99,137,74,20,15,28,89,214
Joe Johnson,SG,40,BOS,1,0,2,1,1,1.0,0,0,,1,1,1.0,1.0,0,0,,0,0,0,0,0,0,0,0,2
Keldon Johnson,SF,22,SAS,51,50,1588,296,635,0.466,96,225,0.427,200,410,0.488,0.542,98,137,0.715,53,258,311,91,37,7,66,94,786
Keon Johnson,SG,19,LAC,15,0,135,17,51,0.333,3,11,0.273,14,40,0.35,0.363,16,21,0.762,6,15,21,13,7,2,7,21,53
Stanley Johnson,PF,25,LAL,22,12,492,55,113,0.487,16,50,0.32,39,63,0.619,0.558,21,31,0.677,15,58,73,28,17,10,13,65,147
Tyler Johnson,PG,29,TOT,6,0,91,6,20,0.3,5,13,0.385,1,7,0.143,0.425,0,0,,3,9,12,7,3,3,2,7,17
Nikola Jokić,C,26,DEN,48,48,1580,474,820,0.578,75,200,0.375,399,620,0.644,0.624,217,266,0.816,128,527,655,378,68,34,174,122,1240
Carlik Jones,PG,24,TOT,5,0,23,1,9,0.111,0,1,0.0,1,8,0.125,0.111,2,2,1.0,1,2,3,5,1,0,3,0,4
Damian Jones,C,26,SAC,37,5,564,90,141,0.638,5,14,0.357,85,127,0.669,0.656,48,66,0.727,52,94,146,42,11,23,37,76,233
Derrick Jones Jr.,PF,24,CHI,31,8,533,71,122,0.582,15,37,0.405,56,85,0.659,0.643,39,46,0.848,37,67,104,16,15,23,16,71,196
Herbert Jones,PF,23,NOP,51,42,1520,186,375,0.496,35,97,0.361,151,278,0.543,0.543,81,97,0.835,65,135,200,105,77,44,58,154,488
Jemerrio Jones,SF,26,LAL,2,0,15,2,3,0.667,0,0,,2,3,0.667,0.667,0,0,,2,1,3,0,1,0,0,2,4
Kai Jones,C,21,CHO,16,0,46,6,9,0.667,1,2,0.5,5,7,0.714,0.722,1,4,0.25,2,6,8,4,0,0,5,5,14
Mason Jones,SG,23,LAL,2,0,9,2,8,0.25,0,2,0.0,2,6,0.333,0.25,1,2,0.5,1,1,2,0,1,0,1,1,5
Tre Jones,PG,22,SAS,43,4,575,85,170,0.5,3,19,0.158,82,151,0.543,0.509,34,38,0.895,17,62,79,101,18,0,24,40,207
Tyus Jones,PG,25,MEM,49,13,1011,157,339,0.463,45,123,0.366,112,216,0.519,0.529,35,40,0.875,13,114,127,201,44,2,35,21,394
DeAndre Jordan,C,33,LAL,31,19,399,59,88,0.67,0,0,,59,88,0.67,0.67,12,25,0.48,49,120,169,13,10,25,20,50,130
Cory Joseph,PG,30,DET,43,17,1031,124,271,0.458,45,103,0.437,79,168,0.47,0.541,67,79,0.848,18,87,105,163,29,11,63,89,360
Georgios Kalaitzakis,SF,23,MIL,9,0,48,5,11,0.455,2,4,0.5,3,7,0.429,0.545,4,9,0.444,4,4,8,0,1,1,4,8,16
Frank Kaminsky,C,28,PHO,9,0,181,36,66,0.545,5,15,0.333,31,51,0.608,0.583,18,20,0.9,11,30,41,13,8,7,5,14,95
Luke Kennard,SG,25,LAC,46,10,1294,187,429,0.436,123,286,0.43,64,143,0.448,0.579,45,51,0.882,11,153,164,101,29,5,37,72,542
Braxton Key,SF,24,PHI,2,0,6,1,2,0.5,0,1,0.0,1,1,1.0,0.5,0,0,,1,1,2,1,1,0,2,1,2
George King,SF,28,DAL,4,0,19,0,5,0.0,0,4,0.0,0,1,0.0,0.0,1,2,0.5,0,5,5,0,0,0,1,4,1
Louis King,SF,22,SAC,10,0,104,15,47,0.319,8,27,0.296,7,20,0.35,0.404,7,10,0.7,0,12,12,9,2,1,0,14,45
Corey Kispert,SF,22,WAS,48,7,890,109,250,0.436,45,142,0.317,64,108,0.593,0.526,36,41,0.878,30,87,117,41,15,12,21,43,299
Maxi Kleber,PF,30,DAL,38,20,952,98,231,0.424,64,171,0.374,34,60,0.567,0.563,27,35,0.771,43,181,224,43,19,38,28,86,287
Brandon Knight,PG,30,DAL,3,0,54,9,20,0.45,4,13,0.308,5,7,0.714,0.55,8,8,1.0,0,7,7,8,1,0,4,5,30
Nathan Knight,PF,24,MIN,28,2,194,27,56,0.482,2,8,0.25,25,48,0.521,0.5,32,45,0.711,22,37,59,14,4,7,12,29,88
Kevin Knox,SF,22,TOT,19,0,153,20,55,0.364,11,38,0.289,9,17,0.529,0.464,7,10,0.7,8,21,29,6,3,1,7,8,58
John Konchar,SG,25,MEM,48,6,884,87,172,0.506,35,83,0.422,52,89,0.584,0.608,20,33,0.606,57,156,213,70,35,13,21,61,229
Furkan Korkmaz,SG,24,PHI,47,17,1130,151,387,0.39,62,216,0.287,89,171,0.52,0.47,57,68,0.838,14,126,140,111,29,6,38,48,421
Luke Kornet,C,26,TOT,3,0,18,1,6,0.167,0,1,0.0,1,5,0.2,0.167,2,3,0.667,3,1,4,1,0,1,0,2,4
Vit Krejci,SG,21,OKC,3,0,9,0,2,0.0,0,2,0.0,0,0,,0.0,2,2,1.0,0,3,3,0,0,0,1,0,2
Arnoldas Kulboka,SF,24,CHO,1,0,3,0,0,,0,0,,0,0,,,0,0,,0,0,0,0,0,0,0,0,0
Jonathan Kuminga,SF,19,GSW,43,4,569,115,235,0.489,24,79,0.304,91,156,0.583,0.54,63,99,0.636,26,87,113,28,15,7,38,74,317
Kyle Kuzma,PF,26,WAS,50,50,1646,302,663,0.456,92,275,0.335,210,388,0.541,0.525,110,159,0.692,57,376,433,140,33,44,111,91,806
Anthony Lamb,SF,24,SAS,2,0,8,0,2,0.0,0,2,0.0,0,0,,0.0,0,0,,0,1,1,2,0,0,0,0,0
Jeremy Lamb,SF-SG,29,TOT,40,0,644,89,239,0.372,42,125,0.336,47,114,0.412,0.46,70,83,0.843,15,85,100,56,23,16,25,45,290
Jock Landale,C,26,SAS,34,1,343,58,117,0.496,19,52,0.365,39,65,0.6,0.577,20,23,0.87,39,38,77,31,7,12,22,32,155
Romeo Langford,SG,22,BOS,44,5,728,79,184,0.429,29,83,0.349,50,101,0.495,0.508,20,34,0.588,30,74,104,19,21,16,16,46,207
Zach LaVine,SF,26,CHI,46,46,1587,406,839,0.484,134,332,0.404,272,507,0.536,0.564,198,226,0.876,13,212,225,204,29,17,125,78,1144
Jake Layman,SF,27,MIN,23,1,169,18,49,0.367,4,26,0.154,14,23,0.609,0.408,6,8,0.75,4,20,24,7,6,4,7,9,46
Damion Lee,SG,29,GSW,44,3,902,128,284,0.451,52,142,0.366,76,142,0.535,0.542,40,47,0.851,17,119,136,40,29,4,29,63,348
Saben Lee,PG,22,DET,27,0,403,46,121,0.38,12,44,0.273,34,77,0.442,0.43,33,43,0.767,10,56,66,64,25,10,25,24,137
Alex Len,C,28,SAC,33,9,557,82,155,0.529,6,19,0.316,76,136,0.559,0.548,36,56,0.643,48,105,153,41,12,25,41,89,206
Caris LeVert,SG,27,TOT,40,39,1242,282,633,0.445,62,192,0.323,220,441,0.499,0.494,113,148,0.764,30,121,151,175,36,18,75,93,739
Kira Lewis Jr.,PG,20,NOP,24,0,341,59,146,0.404,13,58,0.224,46,88,0.523,0.449,10,12,0.833,9,30,39,49,11,1,26,17,141
Scottie Lewis,SG,21,CHO,2,0,7,0,0,,0,0,,0,0,,,1,2,0.5,0,0,0,1,1,0,0,0,1
Damian Lillard,PG,31,POR,29,29,1056,222,552,0.402,92,284,0.324,130,268,0.485,0.486,159,181,0.878,13,107,120,212,17,11,83,37,695
Nassir Little,SF,21,POR,42,23,1088,145,315,0.46,51,154,0.331,94,161,0.584,0.541,69,94,0.734,58,178,236,54,25,36,40,82,410
Isaiah Livers,SF,23,DET,1,0,5,0,2,0.0,0,2,0.0,0,0,,0.0,0,0,,0,0,0,0,1,1,1,1,0
Kevon Looney,C,25,GSW,55,55,1169,142,258,0.55,0,1,0.0,142,257,0.553,0.55,59,89,0.663,152,265,417,91,34,41,53,146,343
Brook Lopez,C,33,MIL,1,1,28,3,9,0.333,2,4,0.5,1,5,0.2,0.444,0,0,,2,3,5,0,1,3,0,3,8
Robin Lopez,C,33,ORL,25,9,444,91,158,0.576,2,5,0.4,89,153,0.582,0.582,20,34,0.588,54,40,94,43,1,14,32,51,204
Didi Louzada,SF,22,NOP,2,0,7,0,3,0.0,0,3,0.0,0,0,,0.0,0,0,,2,0,2,1,0,0,0,0,0
Kevin Love,PF,33,CLE,47,2,1047,215,503,0.427,118,300,0.393,97,203,0.478,0.545,130,152,0.855,56,298,354,102,17,11,61,53,678
Kyle Lowry,PG,35,MIA,42,42,1420,181,435,0.416,87,258,0.337,94,177,0.531,0.516,96,113,0.85,25,158,183,338,46,15,126,115,545
Timothé Luwawu-Cabarrot,SF,26,ATL,34,12,443,48,124,0.387,31,86,0.36,17,38,0.447,0.512,17,20,0.85,8,38,46,26,12,4,13,46,144
Trey Lyles,PF,26,DET,51,3,990,175,384,0.456,44,146,0.301,131,238,0.55,0.513,138,176,0.784,60,184,244,58,22,26,54,91,532
Théo Maledon,PG,20,OKC,28,0,387,34,107,0.318,12,55,0.218,22,52,0.423,0.374,28,33,0.848,9,37,46,31,11,3,23,30,108
Sandro Mamukelashvili,PF,22,MIL,30,2,295,36,82,0.439,15,39,0.385,21,43,0.488,0.53,9,12,0.75,26,30,56,16,7,6,10,18,96
Terance Mann,SF,25,LAC,55,20,1570,212,447,0.474,54,151,0.358,158,296,0.534,0.535,72,95,0.758,73,207,280,129,35,6,54,121,550
Tre Mann,PG,20,OKC,41,9,792,120,318,0.377,53,146,0.363,67,172,0.39,0.461,33,45,0.733,13,77,90,40,28,8,36,71,326
Boban Marjanović,C,33,DAL,17,0,98,36,57,0.632,1,3,0.333,35,54,0.648,0.64,8,16,0.5,7,23,30,2,0,2,11,20,81
Lauri Markkanen,PF,24,CLE,38,38,1148,188,431,0.436,77,225,0.342,111,206,0.539,0.526,63,73,0.863,41,161,202,56,29,21,31,68,516
Naji Marshall,SF,24,NOP,29,0,285,34,95,0.358,6,38,0.158,28,57,0.491,0.389,30,35,0.857,14,49,63,24,13,4,22,29,104
Caleb Martin,SF,26,MIA,44,10,1009,161,318,0.506,44,116,0.379,117,202,0.579,0.575,51,69,0.739,56,118,174,46,42,21,35,71,417
Cody Martin,SF,26,CHO,49,11,1334,144,317,0.454,48,117,0.41,96,200,0.48,0.53,55,82,0.671,61,147,208,128,63,25,44,83,391
Kelan Martin,SF,26,IND,27,1,444,70,168,0.417,22,74,0.297,48,94,0.511,0.482,9,13,0.692,16,37,53,21,13,9,14,36,171
Kenyon Martin Jr.,SF,21,HOU,51,0,999,171,326,0.525,27,93,0.29,144,233,0.618,0.566,54,85,0.635,58,141,199,69,23,26,34,66,423
Garrison Mathews,SG,25,HOU,37,17,1014,121,294,0.412,92,244,0.377,29,50,0.58,0.568,95,116,0.819,20,107,127,39,26,13,23,109,429
Dakota Mathias,SG,26,MEM,6,0,16,2,6,0.333,2,6,0.333,0,0,,0.5,0,0,,0,2,2,1,1,0,0,1,6
Wesley Matthews,SG,35,MIL,27,6,524,52,126,0.413,31,90,0.344,21,36,0.583,0.536,6,10,0.6,15,38,53,19,12,5,10,52,141
Tyrese Maxey,PG,21,PHI,47,46,1681,299,635,0.471,66,166,0.398,233,469,0.497,0.523,128,147,0.871,17,152,169,227,32,26,57,101,792
Skylar Mays,SG,24,ATL,21,5,198,31,60,0.517,8,25,0.32,23,35,0.657,0.583,8,9,0.889,5,20,25,16,7,0,8,7,78
Miles McBride,PG,21,NYK,21,2,151,15,58,0.259,5,31,0.161,10,27,0.37,0.302,3,4,0.75,2,14,16,23,8,1,3,15,38
Mac McClung,PG,23,CHI,1,0,3,1,1,1.0,0,0,,1,1,1.0,1.0,0,0,,0,0,0,0,0,0,1,0,2
CJ McCollum,SG,30,POR,36,36,1267,290,665,0.436,111,289,0.384,179,376,0.476,0.52,48,68,0.706,34,119,153,163,36,21,70,77,739
T.J. McConnell,PG,29,IND,24,6,581,91,181,0.503,7,25,0.28,84,156,0.538,0.522,12,15,0.8,19,61,80,115,25,9,28,43,201
Jaden McDaniels,PF,21,MIN,52,24,1351,176,402,0.438,56,182,0.308,120,220,0.545,0.507,34,44,0.773,61,160,221,61,40,35,54,170,442
Jalen McDaniels,SF,24,CHO,39,2,685,97,197,0.492,32,86,0.372,65,111,0.586,0.574,31,46,0.674,29,107,136,43,20,16,30,70,257
Doug McDermott,PF,30,SAS,39,39,953,172,370,0.465,87,203,0.429,85,167,0.509,0.582,19,27,0.704,15,81,96,48,9,4,30,64,450
JaVale McGee,C,34,PHO,48,14,782,204,310,0.658,2,5,0.4,202,305,0.662,0.661,70,103,0.68,117,223,340,32,14,48,69,119,480
Cameron McGriff,SF,24,POR,3,0,46,5,14,0.357,2,6,0.333,3,8,0.375,0.429,2,2,1.0,6,9,15,3,0,1,0,7,14
Rodney McGruder,SG,30,DET,29,1,386,45,104,0.433,24,61,0.393,21,43,0.488,0.548,10,14,0.714,16,41,57,24,11,2,12,30,124
Alfonzo McKinnie,SF,29,CHI,17,3,206,24,61,0.393,9,27,0.333,15,34,0.441,0.467,2,8,0.25,13,20,33,5,2,3,7,26,59
JaQuori McLaughlin,PG,24,DAL,4,0,11,0,2,0.0,0,1,0.0,0,1,0.0,0.0,0,0,,0,0,0,2,0,0,0,1,0
Jordan McLaughlin,PG,25,MIN,37,3,451,41,107,0.383,8,40,0.2,33,67,0.493,0.421,20,27,0.741,9,40,49,103,27,3,20,20,110
Ben McLemore,SG,28,POR,39,6,715,116,296,0.392,90,238,0.378,26,58,0.448,0.544,25,32,0.781,11,47,58,31,15,5,26,55,347
De'Anthony Melton,SG,23,MEM,47,13,1078,169,440,0.384,75,224,0.335,94,216,0.435,0.469,49,71,0.69,49,163,212,128,76,27,68,84,462
Sam Merrill,SG,25,MEM,6,0,58,8,24,0.333,7,23,0.304,1,1,1.0,0.479,2,4,0.5,1,6,7,4,0,0,2,3,25
Chimezie Metu,C,24,SAC,39,20,876,136,314,0.433,36,133,0.271,100,181,0.552,0.49,41,56,0.732,25,207,232,44,35,23,38,57,349
Khris Middleton,SF,30,MIL,44,44,1402,291,659,0.442,104,276,0.377,187,383,0.488,0.52,171,194,0.881,29,216,245,231,55,13,133,109,857
C.J. Miles,SG,34,BOS,1,0,2,0,0,,0,0,,0,0,,,0,0,,0,0,0,0,0,0,0,1,0
Patty Mills,PG,33,BRK,53,36,1635,255,588,0.434,173,408,0.424,82,180,0.456,0.581,38,43,0.884,12,103,115,135,38,15,50,76,721
Paul Millsap,PF,36,BRK,24,0,270,32,85,0.376,6,27,0.222,26,58,0.448,0.412,12,17,0.706,29,60,89,24,5,11,11,48,82
Shake Milton,PG,25,PHI,27,6,668,109,254,0.429,25,79,0.316,84,175,0.48,0.478,41,48,0.854,13,68,81,75,20,11,31,56,284
Davion Mitchell,PG,23,SAC,51,8,1330,218,534,0.408,70,219,0.32,148,315,0.47,0.474,24,43,0.558,28,90,118,178,36,16,59,98,530
Donovan Mitchell,SG,25,UTA,43,43,1431,398,876,0.454,140,405,0.346,258,471,0.548,0.534,157,180,0.872,38,140,178,226,68,12,127,105,1093
Evan Mobley,PF,20,CLE,47,47,1606,285,572,0.498,18,65,0.277,267,507,0.527,0.514,114,171,0.667,89,295,384,120,35,78,91,94,702
Malik Monk,SG,23,LAL,50,18,1358,238,506,0.47,114,283,0.403,124,223,0.556,0.583,59,75,0.787,21,143,164,125,35,20,69,80,649
Greg Monroe,C,31,TOT,8,0,126,20,38,0.526,0,0,,20,38,0.526,0.526,3,7,0.429,18,25,43,14,4,6,8,14,43
Moses Moody,SG,19,GSW,32,4,306,37,95,0.389,18,57,0.316,19,38,0.5,0.484,14,17,0.824,7,38,45,11,3,5,7,23,106
Xavier Moon,SG,27,LAC,6,0,83,14,34,0.412,3,10,0.3,11,24,0.458,0.456,2,3,0.667,1,8,9,10,5,1,3,4,33
Matt Mooney,SG,24,NYK,1,0,2,0,1,0.0,0,1,0.0,0,0,,0.0,0,0,,0,0,0,0,1,0,1,0,0
Ja Morant,PG,22,MEM,43,43,1425,430,872,0.493,66,192,0.344,364,680,0.535,0.531,214,283,0.756,61,193,254,293,55,17,150,61,1140
Juwan Morgan,PF,24,TOR,1,0,27,2,3,0.667,1,2,0.5,1,1,1.0,0.833,0,0,,2,2,4,1,0,0,0,3,5
Jaylen Morris,SG,26,SAS,3,0,16,0,6,0.0,0,2,0.0,0,4,0.0,0.0,2,4,0.5,0,2,2,2,0,0,1,2,2
Marcus Morris,PF,32,LAC,31,31,927,172,406,0.424,64,167,0.383,108,239,0.452,0.502,73,88,0.83,19,142,161,71,15,9,41,72,481
Markieff Morris,PF,32,MIA,10,0,187,32,70,0.457,8,22,0.364,24,48,0.5,0.514,5,5,1.0,13,15,28,14,3,1,12,22,77
Monte Morris,PG,26,DEN,51,50,1529,260,549,0.474,82,220,0.373,178,329,0.541,0.548,43,51,0.843,19,131,150,219,35,8,53,61,645
Emmanuel Mudiay,PG,25,SAC,2,0,11,0,2,0.0,0,0,,0,2,0.0,0.0,3,4,0.75,0,0,0,4,1,0,1,1,3
Mychal Mulder,PG,27,ORL,15,2,195,20,67,0.299,13,46,0.283,7,21,0.333,0.396,2,2,1.0,2,19,21,3,4,1,8,12,55
Ade Murkey,SG,24,SAC,1,0,1,0,0,,0,0,,0,0,,,0,0,,0,0,0,0,0,0,0,0,0
Trey Murphy III,SF,21,NOP,40,0,514,50,148,0.338,36,107,0.336,14,41,0.341,0.459,24,28,0.857,28,59,87,20,12,6,12,37,160
Dejounte Murray,PG,25,SAS,48,48,1652,389,858,0.453,62,197,0.315,327,661,0.495,0.49,96,129,0.744,64,338,402,440,97,17,120,99,936
Mike Muscala,C,30,OKC,43,0,592,113,248,0.456,70,163,0.429,43,85,0.506,0.597,48,57,0.842,21,108,129,22,18,26,14,58,344
Svi Mykhailiuk,SF,24,TOR,41,5,648,83,204,0.407,35,113,0.31,48,91,0.527,0.493,27,32,0.844,20,67,87,40,24,4,28,47,228
Abdel Nader,SF,28,PHO,14,0,145,12,35,0.343,4,14,0.286,8,21,0.381,0.4,6,10,0.6,4,23,27,7,8,4,11,20,34
Larry Nance Jr.,PF,29,POR,37,11,858,102,198,0.515,19,62,0.306,83,136,0.61,0.563,32,49,0.653,58,151,209,73,38,13,27,67,255
RJ Nembhard Jr.,SG,22,CLE,7,0,44,5,11,0.455,0,1,0.0,5,10,0.5,0.455,1,2,0.5,0,2,2,10,0,0,2,2,11
Aaron Nesmith,SF,22,BOS,39,1,398,46,130,0.354,17,82,0.207,29,48,0.604,0.419,13,16,0.813,10,54,64,12,12,2,21,47,122
Raul Neto,PG,29,WAS,44,0,855,125,284,0.44,17,75,0.227,108,209,0.517,0.47,49,67,0.731,7,78,85,112,31,1,54,65,316
Malik Newman,PG,24,CLE,1,0,8,3,5,0.6,0,1,0.0,3,4,0.75,0.6,2,2,1.0,0,1,1,1,0,0,1,0,8
Georges Niang,PF,28,PHI,50,5,1153,169,386,0.438,98,244,0.402,71,142,0.5,0.565,38,44,0.864,18,113,131,76,21,10,43,130,474
Daishen Nix,SG,19,HOU,8,0,67,13,20,0.65,3,7,0.429,10,13,0.769,0.725,1,3,0.333,1,9,10,10,7,0,9,3,30
Zeke Nnaji,PF,21,DEN,38,1,623,93,170,0.547,36,73,0.493,57,97,0.588,0.653,38,62,0.613,55,85,140,13,12,12,19,73,260
Nerlens Noel,C,27,NYK,25,11,562,32,60,0.533,0,3,0.0,32,57,0.561,0.533,21,30,0.7,48,93,141,23,30,31,20,67,85
Jaylen Nowell,SG,22,MIN,40,1,603,122,263,0.464,35,96,0.365,87,167,0.521,0.53,41,55,0.745,15,65,80,84,23,6,21,48,320
Frank Ntilikina,PG,23,DAL,44,5,567,68,180,0.378,32,94,0.34,36,86,0.419,0.467,23,24,0.958,7,55,62,53,23,6,25,49,191
Jusuf Nurkić,C,27,POR,53,53,1481,297,557,0.533,12,52,0.231,285,505,0.564,0.544,169,248,0.681,154,421,575,143,60,33,134,177,775
David Nwaba,SF,29,HOU,34,4,477,67,141,0.475,10,35,0.286,57,106,0.538,0.511,35,49,0.714,29,101,130,27,22,18,16,41,179
Jordan Nwora,SF,23,MIL,42,9,805,130,319,0.408,59,161,0.366,71,158,0.449,0.5,16,21,0.762,28,130,158,43,20,13,40,48,335
Royce O'Neale,SF,28,UTA,51,51,1600,136,282,0.482,75,189,0.397,61,93,0.656,0.615,33,42,0.786,41,212,253,126,63,25,44,122,380
Semi Ojeleye,PF,27,MIL,20,0,308,18,70,0.257,11,41,0.268,7,29,0.241,0.336,10,13,0.769,25,33,58,5,5,5,5,26,57
Chuma Okeke,PF,23,ORL,45,10,1064,135,349,0.387,62,206,0.301,73,143,0.51,0.476,33,39,0.846,27,175,202,68,61,25,35,61,365
Josh Okogie,SG,23,MIN,33,6,408,26,75,0.347,10,36,0.278,16,39,0.41,0.413,23,37,0.622,25,35,60,18,17,10,17,39,85
Onyeka Okongwu,C,21,ATL,22,6,486,79,108,0.731,0,0,,79,108,0.731,0.731,39,53,0.736,49,77,126,23,16,32,25,72,197
Isaac Okoro,SF,21,CLE,40,34,1148,131,282,0.465,34,109,0.312,97,173,0.561,0.525,68,89,0.764,43,87,130,72,33,12,41,101,364
KZ Okpala,PF,22,MIA,21,0,244,30,69,0.435,9,26,0.346,21,43,0.488,0.5,8,11,0.727,11,30,41,14,4,7,5,25,77
Cameron Oliver,SF,25,ATL,2,0,43,10,15,0.667,1,3,0.333,9,12,0.75,0.7,2,3,0.667,2,4,6,3,1,1,0,5,23
Kelly Olynyk,C,30,DET,17,1,351,62,154,0.403,18,63,0.286,44,91,0.484,0.461,28,44,0.636,24,57,81,51,16,10,27,46,170
Eugene Omoruyi,SF,24,DAL,4,0,18,2,5,0.4,1,2,0.5,1,3,0.333,0.5,2,4,0.5,2,5,7,2,0,0,0,2,7
Miye Oni,SG,24,UTA,16,0,44,2,9,0.222,1,8,0.125,1,1,1.0,0.278,0,1,0.0,1,6,7,5,0,0,1,7,5
Cedi Osman,SF,26,CLE,43,3,998,164,391,0.419,88,246,0.358,76,145,0.524,0.532,50,79,0.633,18,83,101,84,39,8,38,83,466
Daniel Oturu,C,22,TOR,3,0,27,3,6,0.5,0,1,0.0,3,5,0.6,0.5,3,5,0.6,1,4,5,0,0,2,0,1,9
Kelly Oubre Jr.,SF,26,CHO,50,11,1423,301,682,0.441,141,402,0.351,160,280,0.571,0.545,88,128,0.688,57,149,206,58,58,21,50,126,831
Jaysean Paige,PG,27,DET,1,0,7,0,3,0.0,0,2,0.0,0,1,0.0,0.0,0,0,,0,1,1,1,0,0,1,2,0
Trayvon Palmer,SG,27,DET,1,0,17,0,1,0.0,0,0,,0,1,0.0,0.0,0,0,,0,2,2,0,0,0,1,2,0
Kevin Pangos,PG,29,CLE,24,3,166,15,46,0.326,6,26,0.231,9,20,0.45,0.391,3,4,0.75,2,9,11,30,3,0,7,11,39
Jabari Parker,PF,26,BOS,12,0,112,18,38,0.474,8,16,0.5,10,22,0.455,0.579,9,9,1.0,5,23,28,6,4,1,8,13,53
Eric Paschall,PF,25,UTA,41,1,544,81,167,0.485,32,86,0.372,49,81,0.605,0.581,46,61,0.754,24,61,85,23,5,4,25,39,240
Chris Paul,PG,36,PHO,54,54,1798,306,626,0.489,57,168,0.339,249,458,0.544,0.534,142,171,0.83,16,226,242,565,101,18,128,114,811
Cameron Payne,PG,27,PHO,40,0,815,158,391,0.404,45,134,0.336,113,257,0.44,0.462,57,66,0.864,16,94,110,144,23,12,71,75,418
Elfrid Payton,PG,27,PHO,34,0,397,48,124,0.387,2,12,0.167,46,112,0.411,0.395,10,22,0.455,17,50,67,69,18,4,35,31,108
Gary Payton II,PG,29,GSW,52,9,872,154,247,0.623,33,88,0.375,121,159,0.761,0.69,27,46,0.587,54,134,188,42,70,17,25,86,368
Norvel Pelle,C,28,UTA,3,0,19,3,5,0.6,0,0,,3,5,0.6,0.6,0,0,,3,3,6,0,0,1,2,1,6
Reggie Perry,PF,21,TOT,3,0,51,5,10,0.5,1,2,0.5,4,8,0.5,0.55,2,2,1.0,2,6,8,2,1,0,1,9,13
Jamorko Pickett,PF,24,DET,6,0,47,1,10,0.1,1,7,0.143,0,3,0.0,0.15,0,0,,2,7,9,1,0,1,3,3,3
Theo Pinson,SF,26,DAL,16,0,120,9,32,0.281,6,25,0.24,3,7,0.429,0.375,4,4,1.0,1,18,19,13,4,2,2,9,28
Mason Plumlee,C,31,CHO,47,47,1196,140,222,0.631,0,2,0.0,140,220,0.636,0.631,35,103,0.34,117,248,365,137,45,31,62,143,315
Jakob Poeltl,C,26,SAS,45,44,1296,267,435,0.614,0,0,,267,435,0.614,0.614,56,122,0.459,178,229,407,124,33,78,70,134,590
Aleksej Pokusevski,PF,20,OKC,38,2,601,81,211,0.384,26,97,0.268,55,114,0.482,0.445,7,14,0.5,37,121,158,44,22,19,44,46,195
Yves Pons,SF,22,MEM,7,0,22,1,3,0.333,1,1,1.0,0,2,0.0,0.5,0,2,0.0,2,3,5,0,0,0,0,2,3
Jordan Poole,SG,22,GSW,49,35,1430,277,632,0.438,119,348,0.342,158,284,0.556,0.532,144,156,0.923,22,132,154,170,40,15,115,129,817
Kevin Porter Jr.,PG,21,HOU,37,37,1108,171,436,0.392,81,220,0.368,90,216,0.417,0.485,73,118,0.619,27,120,147,225,44,10,133,95,496
Michael Porter Jr.,SF,23,DEN,9,9,265,37,103,0.359,10,48,0.208,27,55,0.491,0.408,5,9,0.556,9,50,59,17,10,2,12,16,89
Otto Porter Jr.,PF,28,GSW,45,13,972,145,305,0.475,69,173,0.399,76,132,0.576,0.589,24,33,0.727,43,187,230,71,50,22,23,60,383
Bobby Portis,C,26,MIL,47,42,1351,285,583,0.489,94,220,0.427,191,363,0.526,0.569,67,87,0.77,122,304,426,61,34,39,70,125,731
Kristaps Porziņģis,PF,26,DAL,34,34,1002,229,508,0.451,49,173,0.283,180,335,0.537,0.499,147,170,0.865,64,197,261,69,25,59,53,88,654
Micah Potter,C,23,DET,3,0,31,5,11,0.455,0,2,0.0,5,9,0.556,0.455,2,2,1.0,4,5,9,0,1,1,1,4,12
Dwight Powell,C,30,DAL,55,44,1116,152,236,0.644,12,31,0.387,140,205,0.683,0.669,89,119,0.748,108,134,242,60,28,22,42,135,405
Myles Powell,PG,24,PHI,11,0,52,5,17,0.294,1,6,0.167,4,11,0.364,0.324,2,2,1.0,1,5,6,3,1,0,3,8,13
Norman Powell,SF-SG,28,TOT,42,40,1380,262,570,0.46,98,240,0.408,164,330,0.497,0.546,168,208,0.808,18,116,134,88,41,19,65,98,790
Joshua Primo,SG,19,SAS,26,4,400,44,121,0.364,20,63,0.317,24,58,0.414,0.446,14,18,0.778,16,27,43,36,9,14,27,27,122
Taurean Prince,PF,27,MIN,44,8,685,91,200,0.455,48,122,0.393,43,78,0.551,0.575,28,37,0.757,18,86,104,39,26,10,31,64,258
Payton Pritchard,SG,24,BOS,45,2,548,79,205,0.385,46,124,0.371,33,81,0.407,0.498,14,14,1.0,12,58,70,75,8,4,29,39,218
Trevelin Queen,SG,24,HOU,8,0,69,13,29,0.448,8,22,0.364,5,7,0.714,0.586,3,3,1.0,5,9,14,3,5,0,7,6,37
Neemias Queta,C,22,SAC,10,0,56,9,23,0.391,0,0,,9,23,0.391,0.391,3,5,0.6,11,8,19,4,1,4,4,11,21
Immanuel Quickley,PG,22,NYK,51,2,1108,161,439,0.367,83,251,0.331,78,188,0.415,0.461,83,91,0.912,17,102,119,154,32,3,64,115,488
Jahmi'us Ramsey,SG,20,SAC,19,0,134,24,58,0.414,5,18,0.278,19,40,0.475,0.457,7,14,0.5,4,9,13,7,1,1,5,10,60
Julius Randle,PF,27,NYK,53,53,1874,367,874,0.42,88,284,0.31,279,590,0.473,0.47,191,254,0.752,99,428,527,271,42,31,184,150,1013
Austin Reaves,SG,23,LAL,37,0,780,74,157,0.471,29,90,0.322,45,67,0.672,0.564,42,51,0.824,21,74,95,46,11,8,20,51,219
Cam Reddish,SF,22,TOT,39,7,847,142,359,0.396,59,162,0.364,83,197,0.421,0.478,83,91,0.912,21,70,91,38,37,12,48,46,426
Davon Reed,SG,26,DEN,28,3,399,45,95,0.474,23,53,0.434,22,42,0.524,0.595,4,5,0.8,10,63,73,29,17,3,8,40,117
Paul Reed,C,22,PHI,21,2,185,20,43,0.465,0,4,0.0,20,39,0.513,0.465,3,8,0.375,20,27,47,10,12,10,7,28,43
Naz Reid,C,22,MIN,52,5,830,156,334,0.467,40,116,0.345,116,218,0.532,0.527,75,103,0.728,76,126,202,44,23,52,56,112,427
Nick Richards,C,24,CHO,40,5,340,55,81,0.679,0,0,,55,81,0.679,0.679,30,41,0.732,30,50,80,13,9,19,20,48,140
Josh Richardson,SG,28,BOS,44,0,1087,152,343,0.443,62,156,0.397,90,187,0.481,0.534,61,71,0.859,26,99,125,66,34,23,39,82,427
Austin Rivers,SG,29,DEN,40,13,845,89,219,0.406,51,145,0.352,38,74,0.514,0.523,19,27,0.704,13,51,64,43,28,4,32,63,248
Duncan Robinson,SG,27,MIA,52,47,1425,205,520,0.394,158,437,0.362,47,83,0.566,0.546,37,45,0.822,19,139,158,78,33,11,45,137,605
Justin Robinson,PG,24,TOT,25,0,304,28,93,0.301,18,61,0.295,10,32,0.313,0.398,4,8,0.5,4,17,21,32,9,1,17,27,78
Mitchell Robinson,C,23,NYK,49,40,1243,178,228,0.781,0,0,,178,228,0.781,0.781,65,126,0.516,186,242,428,23,29,78,38,130,421
Jeremiah Robinson-Earl,C,21,OKC,44,36,1014,117,292,0.401,50,150,0.333,67,142,0.472,0.486,30,42,0.714,71,183,254,44,27,15,35,74,314
Isaiah Roby,PF,23,OKC,18,5,246,47,84,0.56,11,22,0.5,36,62,0.581,0.625,16,21,0.762,20,39,59,13,4,6,15,26,121
Rajon Rondo,PG,35,TOT,29,0,515,48,140,0.343,21,67,0.313,27,73,0.37,0.418,14,17,0.824,13,71,84,119,22,5,54,44,131
Derrick Rose,PG,33,NYK,26,4,636,122,274,0.445,37,92,0.402,85,182,0.467,0.513,30,31,0.968,21,57,78,103,22,12,39,15,311
Terrence Ross,SG,30,ORL,47,0,1150,176,435,0.405,62,201,0.308,114,234,0.487,0.476,97,111,0.874,15,108,123,95,24,12,65,55,511
Terry Rozier,SG,27,CHO,47,47,1566,318,740,0.43,140,382,0.366,178,358,0.497,0.524,87,108,0.806,33,163,196,189,52,16,60,67,863
Ricky Rubio,PG,31,CLE,34,8,970,149,411,0.363,59,174,0.339,90,237,0.38,0.434,88,103,0.854,15,126,141,225,49,7,90,75,445
D'Angelo Russell,PG,25,MIN,41,41,1314,270,656,0.412,124,351,0.353,146,305,0.479,0.506,116,144,0.806,15,132,147,288,39,20,107,88,780
Domantas Sabonis,C-PF,25,TOT,48,47,1665,341,590,0.578,35,109,0.321,306,481,0.636,0.608,193,261,0.739,160,421,581,241,47,22,147,150,910
Olivier Sarr,C,22,OKC,2,0,14,1,3,0.333,0,1,0.0,1,2,0.5,0.333,2,2,1.0,0,5,5,0,0,2,0,1,4
Tomáš Satoranský,SG,30,NOP,32,3,481,32,107,0.299,5,31,0.161,27,76,0.355,0.322,19,25,0.76,18,46,64,76,14,1,23,33,88
Jordan Schakel,SG,23,WAS,2,0,14,0,6,0.0,0,3,0.0,0,3,0.0,0.0,0,0,,2,1,3,0,0,0,0,0,0
Admiral Schofield,SF,24,ORL,20,1,235,27,55,0.491,11,33,0.333,16,22,0.727,0.591,3,5,0.6,6,37,43,15,2,3,11,28,68
Dennis Schröder,SG,28,BOS,49,25,1433,257,584,0.44,67,192,0.349,190,392,0.485,0.497,123,145,0.848,28,136,164,208,41,5,104,116,704
Tre Scott,SF,25,CLE,2,0,11,3,6,0.5,0,1,0.0,3,5,0.6,0.5,0,0,,1,1,2,0,1,1,0,2,6
Jay Scrubb,SG,21,LAC,18,0,121,18,46,0.391,6,21,0.286,12,25,0.48,0.457,7,10,0.7,2,14,16,8,4,3,7,9,49
Wayne Selden,SG,27,NYK,3,0,19,1,4,0.25,1,2,0.5,0,2,0.0,0.375,2,4,0.5,0,1,1,1,0,0,0,1,5
Alperen Şengün,C,19,HOU,46,4,858,142,295,0.481,15,58,0.259,127,237,0.536,0.507,106,150,0.707,78,138,216,112,37,44,94,133,405
Collin Sexton,SG,23,CLE,11,11,316,68,151,0.45,11,45,0.244,57,106,0.538,0.487,29,39,0.744,13,23,36,23,10,0,31,25,176
Landry Shamet,SG,24,PHO,45,7,891,107,289,0.37,71,201,0.353,36,88,0.409,0.493,46,54,0.852,11,75,86,71,21,4,24,52,331
Day'Ron Sharpe,PF,20,BRK,26,8,326,71,126,0.563,1,4,0.25,70,122,0.574,0.567,18,30,0.6,67,63,130,12,7,15,27,54,161
Pascal Siakam,PF,27,TOR,40,40,1516,329,675,0.487,44,124,0.355,285,551,0.517,0.52,162,220,0.736,86,268,354,208,52,32,110,138,864
Chris Silva,PF,25,TOT,10,0,91,8,15,0.533,0,0,,8,15,0.533,0.533,10,12,0.833,13,23,36,7,0,1,8,20,26
Marko Simonovic,C,22,CHI,9,0,35,4,15,0.267,1,5,0.2,3,10,0.3,0.3,8,11,0.727,5,5,10,0,1,1,2,6,17
Anfernee Simons,SG,22,POR,50,23,1449,292,665,0.439,144,367,0.392,148,298,0.497,0.547,79,89,0.888,23,110,133,185,27,6,94,94,807
Jericho Sims,PF,23,NYK,17,0,111,8,11,0.727,0,0,,8,11,0.727,0.727,3,4,0.75,11,16,27,1,3,7,2,8,19
Deividas Sirvydis,SG,21,DET,3,0,27,1,10,0.1,1,7,0.143,0,3,0.0,0.15,0,0,,0,6,6,1,3,1,0,4,3
Javonte Smart,PG,22,MIL,13,1,160,11,43,0.256,4,18,0.222,7,25,0.28,0.302,5,6,0.833,4,15,19,14,4,2,9,11,31
Marcus Smart,PG,27,BOS,47,47,1549,190,459,0.414,71,225,0.316,119,234,0.509,0.491,91,115,0.791,29,157,186,252,86,14,97,116,542
Dennis Smith Jr.,PG,24,POR,37,4,638,79,189,0.418,6,27,0.222,73,162,0.451,0.434,42,64,0.656,20,68,88,132,45,12,51,52,206
Ish Smith,PG,33,CHO,37,1,511,73,185,0.395,10,25,0.4,63,160,0.394,0.422,12,19,0.632,11,46,57,98,20,10,36,34,168
Jalen Smith,PF,21,PHO,29,4,382,63,137,0.46,9,39,0.231,54,98,0.551,0.493,40,52,0.769,55,84,139,6,6,18,22,52,175
Xavier Sneed,SF,24,MEM,2,0,8,0,2,0.0,0,2,0.0,0,0,,0.0,0,0,,1,1,2,0,0,0,0,2,0
Tony Snell,SG,30,POR,38,10,546,36,97,0.371,24,75,0.32,12,22,0.545,0.495,3,3,1.0,11,61,72,20,8,7,11,44,99
Jaden Springer,SG,19,PHI,2,0,6,1,1,1.0,0,0,,1,1,1.0,1.0,0,0,,1,1,2,0,0,2,1,0,2
Cassius Stanley,SG,22,DET,9,1,155,19,46,0.413,4,17,0.235,15,29,0.517,0.457,10,10,1.0,5,14,19,4,5,2,6,17,52
Nik Stauskas,SG,28,MIA,2,0,24,3,8,0.375,2,4,0.5,1,4,0.25,0.5,3,4,0.75,1,2,3,1,0,0,0,1,11
Lance Stephenson,SG-SF,31,TOT,26,1,445,78,173,0.451,14,54,0.259,64,119,0.538,0.491,33,42,0.786,10,66,76,96,10,1,41,49,203
Lamar Stevens,PF,24,CLE,39,8,576,83,174,0.477,13,43,0.302,70,131,0.534,0.514,25,40,0.625,29,61,90,25,20,9,22,58,204
Isaiah Stewart,C,20,DET,46,46,1194,160,309,0.518,3,24,0.125,157,285,0.551,0.523,44,67,0.657,139,253,392,50,15,52,60,134,367
Max Strus,SF,25,MIA,43,9,1038,167,376,0.444,116,283,0.41,51,93,0.548,0.598,31,40,0.775,19,124,143,56,14,9,34,73,481
Jalen Suggs,PG,20,ORL,35,32,979,150,410,0.366,36,147,0.245,114,263,0.433,0.41,92,119,0.773,22,107,129,146,42,14,110,105,428
Craig Sword,SG,28,WAS,3,0,19,3,4,0.75,0,1,0.0,3,3,1.0,0.75,0,0,,0,0,0,1,4,0,1,7,6
Keifer Sykes,PG,28,IND,18,10,353,44,120,0.367,17,56,0.304,27,64,0.422,0.438,12,14,0.857,6,29,35,38,7,3,24,36,117
Jae'Sean Tate,SF,26,HOU,52,51,1418,251,502,0.5,41,136,0.301,210,366,0.574,0.541,98,140,0.7,90,201,291,159,52,31,98,192,641
Jayson Tatum,SF,23,BOS,52,52,1874,463,1075,0.431,143,436,0.328,320,639,0.501,0.497,258,307,0.84,61,376,437,214,50,36,151,123,1327
Terry Taylor,SG,22,IND,10,1,166,37,67,0.552,4,7,0.571,33,60,0.55,0.582,8,10,0.8,35,31,66,16,1,2,4,18,86
Garrett Temple,SG,35,NOP,50,16,984,100,262,0.382,51,160,0.319,49,102,0.48,0.479,28,39,0.718,27,105,132,65,39,20,38,77,279
Emanuel Terry,PF,25,PHO,3,0,18,0,5,0.0,0,0,,0,5,0.0,0.0,0,0,,8,7,15,2,1,0,5,4,0
Tyrell Terry,PG,21,MEM,2,0,3,1,1,1.0,0,0,,1,1,1.0,1.0,0,0,,0,0,0,0,0,0,0,1,2
Jon Teske,C,24,MEM,3,0,8,0,1,0.0,0,0,,0,1,0.0,0.0,0,2,0.0,0,2,2,1,1,0,0,1,0
Daniel Theis,C,29,HOU,26,21,584,84,179,0.469,23,79,0.291,61,100,0.61,0.534,27,40,0.675,32,98,130,20,11,17,31,62,218
Brodric Thomas,SG,25,BOS,7,0,28,1,9,0.111,0,6,0.0,1,3,0.333,0.111,2,2,1.0,2,3,5,5,0,0,3,1,4
Cam Thomas,SG,20,BRK,43,1,785,144,329,0.438,31,120,0.258,113,209,0.541,0.485,47,60,0.783,8,96,104,51,22,7,36,36,366
Isaiah Thomas,PG,32,TOT,5,1,114,15,47,0.319,5,25,0.2,10,22,0.455,0.372,8,11,0.727,1,7,8,10,0,2,5,12,43
Matt Thomas,SG,27,CHI,32,0,417,50,121,0.413,33,82,0.402,17,39,0.436,0.55,13,17,0.765,3,42,45,19,7,2,6,17,146
Klay Thompson,SG,31,GSW,12,12,287,72,169,0.426,34,90,0.378,38,79,0.481,0.527,22,22,1.0,6,34,40,36,8,6,19,17,200
Tristan Thompson,PF,30,SAC,30,3,455,76,151,0.503,1,1,1.0,75,150,0.5,0.507,32,60,0.533,72,89,161,18,11,12,29,52,185
JT Thor,PF,19,CHO,15,0,128,11,32,0.344,5,20,0.25,6,12,0.5,0.422,7,10,0.7,6,13,19,8,4,6,5,14,34
Matisse Thybulle,SG,24,PHI,39,24,1034,91,181,0.503,30,95,0.316,61,86,0.709,0.586,13,19,0.684,21,69,90,44,68,44,25,87,225
Killian Tillie,C,23,MEM,32,3,427,42,116,0.362,26,77,0.338,16,39,0.41,0.474,5,8,0.625,20,35,55,20,23,14,11,53,115
Xavier Tillman Sr.,PF,23,MEM,39,0,510,69,153,0.451,7,35,0.2,62,118,0.525,0.474,31,48,0.646,46,70,116,40,41,14,26,49,176
Isaiah Todd,PF,20,WAS,9,0,35,5,15,0.333,4,10,0.4,1,5,0.2,0.467,2,4,0.5,2,7,9,1,2,2,1,1,16
Obi Toppin,PF,23,NYK,50,2,775,146,279,0.523,20,84,0.238,126,195,0.646,0.559,63,84,0.75,46,136,182,46,14,22,37,68,375
Juan Toscano-Anderson,SF,28,GSW,53,5,799,98,200,0.49,22,72,0.306,76,128,0.594,0.545,34,57,0.596,26,118,144,103,39,15,59,85,252
Karl-Anthony Towns,C,26,MIN,48,48,1648,415,796,0.521,102,251,0.406,313,545,0.574,0.585,232,284,0.817,135,323,458,190,48,56,158,173,1164
Gary Trent Jr.,SG,23,TOR,44,43,1533,291,675,0.431,139,347,0.401,152,328,0.463,0.534,81,99,0.818,15,104,119,86,84,14,42,94,802
P.J. Tucker,PF,36,MIA,48,47,1359,152,302,0.503,69,147,0.469,83,155,0.535,0.618,34,47,0.723,68,193,261,103,41,11,47,112,407
Rayjon Tucker,SG,24,DEN,3,0,29,1,2,0.5,1,2,0.5,0,0,,0.75,3,4,0.75,1,3,4,4,1,0,0,3,6
Myles Turner,C,25,IND,42,42,1235,200,393,0.509,61,183,0.333,139,210,0.662,0.587,79,105,0.752,65,232,297,44,28,118,54,119,540
Jonas Valančiūnas,C,29,NOP,48,48,1503,332,628,0.529,45,112,0.402,287,516,0.556,0.564,158,194,0.814,161,397,558,123,24,43,121,158,867
Denzel Valentine,SG,28,TOT,24,0,222,25,66,0.379,19,47,0.404,6,19,0.316,0.523,0,0,,9,33,42,11,8,0,12,20,69
Jarred Vanderbilt,PF,22,MIN,50,43,1301,151,255,0.592,2,11,0.182,149,244,0.611,0.596,59,89,0.663,158,292,450,68,77,37,51,130,363
Fred VanVleet,PG,27,TOR,48,48,1851,350,838,0.418,191,481,0.397,159,357,0.445,0.532,144,165,0.873,37,183,220,341,80,25,131,115,1035
Devin Vassell,SF,21,SAS,47,8,1195,205,474,0.432,82,238,0.345,123,236,0.521,0.519,42,53,0.792,26,175,201,72,46,29,35,98,534
Gabe Vincent,PG,25,MIA,46,19,1099,156,362,0.431,89,227,0.392,67,135,0.496,0.554,32,40,0.8,18,75,93,153,46,11,74,114,433
Nikola Vučević,C,31,CHI,48,48,1618,355,762,0.466,76,231,0.329,279,531,0.525,0.516,56,77,0.727,98,461,559,174,46,58,87,119,842
Dean Wade,PF,25,CLE,40,22,763,75,167,0.449,41,112,0.366,34,55,0.618,0.572,14,23,0.609,25,95,120,45,22,5,16,63,205
Franz Wagner,SF,20,ORL,56,56,1795,335,722,0.464,70,195,0.359,265,527,0.503,0.512,136,160,0.85,61,198,259,166,49,26,91,121,876
Moritz Wagner,C,24,ORL,45,0,564,119,238,0.5,41,124,0.331,78,114,0.684,0.586,63,79,0.797,22,88,110,49,13,10,32,82,342
Ish Wainright,PF,27,PHO,27,0,201,21,58,0.362,9,31,0.29,12,27,0.444,0.44,2,5,0.4,19,16,35,9,8,4,10,32,53
Kemba Walker,PG,31,NYK,33,33,853,134,334,0.401,65,178,0.365,69,156,0.442,0.499,49,60,0.817,12,92,104,115,25,5,45,36,382
Lonnie Walker IV,SG,23,SAS,50,6,1133,202,521,0.388,70,238,0.294,132,283,0.466,0.455,74,89,0.831,12,115,127,117,34,16,53,71,548
M.J. Walker,SG,23,PHO,2,0,8,0,4,0.0,0,2,0.0,0,2,0.0,0.0,0,0,,0,1,1,1,2,0,0,1,0
Derrick Walton,PG,26,DET,3,3,108,6,26,0.231,3,13,0.231,3,13,0.231,0.288,4,4,1.0,2,8,10,21,7,4,11,8,19
Brad Wanamaker,PG,32,TOT,23,2,320,28,77,0.364,4,17,0.235,24,60,0.4,0.39,23,25,0.92,6,33,39,55,7,6,23,45,83
Duane Washington Jr.,PG,21,IND,24,7,505,86,224,0.384,40,115,0.348,46,109,0.422,0.473,21,26,0.808,2,47,49,49,11,1,25,30,233
P.J. Washington,PF,23,CHO,39,4,958,136,305,0.446,71,184,0.386,65,121,0.537,0.562,43,59,0.729,51,162,213,79,28,35,52,96,386
Yuta Watanabe,SF,27,TOR,23,4,353,41,103,0.398,20,57,0.351,21,46,0.457,0.495,14,26,0.538,14,56,70,15,7,10,16,31,116
Tremont Waters,PG,24,TOT,3,0,50,4,14,0.286,2,9,0.222,2,5,0.4,0.357,0,0,,0,4,4,7,5,0,4,4,10
Trendon Watford,SF,21,POR,30,0,364,56,96,0.583,0,10,0.0,56,86,0.651,0.583,21,31,0.677,24,63,87,27,9,14,20,49,133
Paul Watson,SF,27,OKC,9,3,156,12,35,0.343,6,26,0.231,6,9,0.667,0.429,1,2,0.5,3,24,27,8,3,3,4,10,31
Quinndary Weatherspoon,SG,25,GSW,5,0,33,6,10,0.6,0,1,0.0,6,9,0.667,0.6,2,2,1.0,1,5,6,2,1,1,3,7,14
Russell Westbrook,PG,33,LAL,55,55,1902,381,876,0.435,57,191,0.298,324,685,0.473,0.467,187,281,0.665,75,355,430,419,58,15,224,164,1006
Coby White,PG,21,CHI,35,12,961,164,375,0.437,72,199,0.362,92,176,0.523,0.533,53,63,0.841,10,86,96,92,16,10,43,78,453
Derrick White,SG,27,SAS,49,48,1486,243,570,0.426,81,258,0.314,162,312,0.519,0.497,139,160,0.869,25,148,173,274,49,42,87,116,706
Hassan Whiteside,C,32,UTA,43,7,786,146,233,0.627,0,0,,146,233,0.627,0.627,74,113,0.655,101,218,319,17,13,64,39,128,366
Joe Wieskamp,SG,22,SAS,14,0,88,13,27,0.481,8,18,0.444,5,9,0.556,0.63,3,7,0.429,2,5,7,4,2,2,1,5,37
Aaron Wiggins,SG,23,OKC,31,18,680,85,175,0.486,26,79,0.329,59,96,0.615,0.56,33,47,0.702,29,80,109,33,23,6,27,57,229
Andrew Wiggins,SF,26,GSW,50,50,1580,339,701,0.484,114,275,0.415,225,426,0.528,0.565,109,163,0.669,50,162,212,106,50,34,76,96,901
Lindell Wigginton,PG,23,MIL,6,0,25,6,6,1.0,2,2,1.0,4,4,1.0,1.167,0,0,,0,1,1,3,2,1,1,3,14
Brandon Williams,PG,22,POR,2,0,12,2,3,0.667,0,0,,2,3,0.667,0.667,4,7,0.571,0,2,2,2,0,0,0,0,8
Grant Williams,PF,23,BOS,51,13,1165,125,259,0.483,75,175,0.429,50,84,0.595,0.627,43,48,0.896,40,126,166,56,26,36,39,110,368
Kenrich Williams,SF,27,OKC,46,0,995,134,299,0.448,40,114,0.351,94,185,0.508,0.515,23,44,0.523,71,131,202,100,41,9,46,74,331
Lou Williams,PG,35,ATL,37,0,541,90,226,0.398,28,79,0.354,62,147,0.422,0.46,48,54,0.889,11,47,58,73,19,3,29,36,256
Patrick Williams,PF,20,CHI,5,5,125,13,23,0.565,3,6,0.5,10,17,0.588,0.63,4,4,1.0,1,10,11,3,3,2,2,9,33
Robert Williams,C,24,BOS,45,45,1335,196,266,0.737,0,1,0.0,196,265,0.74,0.737,51,72,0.708,173,254,427,90,41,99,52,93,443
Ziaire Williams,SF,20,MEM,36,15,775,104,240,0.433,39,139,0.281,65,101,0.644,0.515,19,22,0.864,11,55,66,33,19,7,20,70,266
D.J. Wilson,PF,25,TOR,3,1,48,8,11,0.727,0,2,0.0,8,9,0.889,0.727,8,10,0.8,1,13,14,4,5,1,2,5,24
Dylan Windler,SF,25,CLE,37,0,344,33,77,0.429,21,54,0.389,12,23,0.522,0.565,7,9,0.778,14,48,62,25,9,2,13,37,94
Justise Winslow,SF,25,TOT,40,3,565,76,169,0.45,7,41,0.171,69,128,0.539,0.47,26,43,0.605,33,122,155,59,27,21,42,50,185
Cassius Winston,PG,23,WAS,2,0,7,0,2,0.0,0,2,0.0,0,0,,0.0,2,2,1.0,0,0,0,2,0,0,1,0,2
Christian Wood,C,26,HOU,51,50,1584,331,686,0.483,95,254,0.374,236,432,0.546,0.552,148,240,0.617,88,435,523,109,39,48,97,126,905
Robert Woodard II,SF,22,SAC,12,0,42,2,16,0.125,1,4,0.25,1,12,0.083,0.156,2,2,1.0,5,6,11,3,1,1,1,3,7
Delon Wright,SG,29,ATL,49,5,893,76,173,0.439,26,67,0.388,50,106,0.472,0.514,33,40,0.825,32,99,131,125,50,10,33,36,211
McKinley Wright IV,PG,23,MIN,3,0,9,2,3,0.667,1,2,0.5,1,1,1.0,0.833,0,0,,0,0,0,1,0,0,1,1,5
Moses Wright,PF,23,LAC,1,0,1,0,0,,0,0,,0,0,,,0,0,,0,0,0,1,0,0,0,0,0
Thaddeus Young,PF,33,SAS,26,1,370,74,128,0.578,0,5,0.0,74,123,0.602,0.578,10,22,0.455,40,53,93,59,23,7,30,38,158
Trae Young,PG,23,ATL,49,49,1692,462,1009,0.458,144,380,0.379,318,629,0.506,0.529,296,331,0.894,30,162,192,457,48,5,203,79,1364
Omer Yurtseven,C,23,MIA,39,10,558,101,193,0.523,1,7,0.143,100,186,0.538,0.526,32,50,0.64,67,167,234,42,15,18,34,68,235
Cody Zeller,C,29,POR,27,0,355,51,90,0.567,0,4,0.0,51,86,0.593,0.567,38,49,0.776,50,75,125,22,8,6,19,56,140
Ivica Zubac,C,24,LAC,50,50,1197,179,276,0.649,0,0,,179,276,0.649,0.649,114,155,0.735,130,268,398,63,22,51,69,124,472
